{
"row":13,
"col":7,
"isloop":0,
"datas":[2,1,1,1,1,1,1,1,1,1,1,1,1,
2,1,1,1,1,2,2,1,1,1,1,2,1,
1,1,2,2,1,1,1,1,2,2,1,1,1,
1,2,2,2,2,2,2,2,2,2,2,2,2,
1,1,1,1,1,1,1,1,1,1,1,1,1,
2,1,1,1,1,1,1,1,1,1,1,1,1,
2,0,2,2,2,2,2,2,2,2,2,2,2],

"it1":[506,0,0,0,0,0,0,0,0,0,0,0,0,
0,0,0,0,0,509,0,0,0,0,0,404,0,
0,0,510,0,0,0,0,0,511,0,0,0,0,
0,503,0,0,401,508,0,503,0,0,508,0,401,
0,0,0,0,0,0,0,0,0,0,0,0,0,
504,0,0,0,0,0,0,0,0,0,0,0,0,
0,0,508,0,500,508,0,401,508,0,0,509,0],

"it2":[0,0,0,0,0,0,0,0,0,0,0,0,0,
3031,0,0,0,0,0,0,0,0,0,0,1340,0,
0,0,0,0,0,0,0,0,0,0,0,0,0,
0,2021,0,0,0,0,0,0,0,0,0,0,0,
0,0,0,0,0,0,0,0,0,0,0,0,0,
0,0,0,0,0,0,0,0,0,0,0,0,0,
0,0,0,0,0,0,0,0,0,0,0,0,0],

"point1": [[1,0],[12,0],[12,2],[10,2],[10,1],[7,1],[7,2],[4,2],[4,1],[1,1],[1,2],[0,2],[0,4],[12,4],[12,5],[1,5]],
"point2": [[1,0],[12,0],[12,2],[10,2],[10,1],[7,1],[7,2],[4,2],[4,1],[1,1],[1,2],[0,2],[0,4],[12,4],[12,5],[1,5]]

}
