{
"row":23,
"col":7,
"isloop":0,
"datas":[2,2,1,1,1,1,1,1,1,1,1,1,1,1,1,1,1,1,1,1,1,2,2,
2,2,1,2,2,1,1,1,1,1,1,1,1,1,1,1,1,1,2,2,1,2,2,
2,2,1,2,2,1,2,2,2,2,2,2,2,2,2,2,2,1,2,2,1,2,2,
2,2,1,2,2,1,1,1,1,1,1,1,1,1,1,1,1,1,2,2,1,2,2,
2,2,1,2,2,1,2,2,2,2,2,2,2,2,2,2,2,1,2,2,1,2,2,
2,2,1,1,1,1,1,1,1,1,1,1,1,1,1,1,1,1,1,1,1,2,2,
2,2,2,2,2,2,2,2,2,2,2,0,2,2,2,2,2,2,2,2,2,2,2],

"it1":[414,0,0,0,0,0,0,0,0,0,0,0,0,0,0,0,0,0,0,0,0,414,0,
0,0,0,450,0,0,0,0,0,0,0,0,0,0,0,0,0,0,451,0,0,0,0,
447,0,0,0,0,0,412,0,449,0,0,412,0,449,0,0,412,0,0,0,0,447,0,
0,401,0,451,0,0,0,0,0,0,0,0,0,0,0,0,0,0,450,0,0,401,0,
447,0,0,0,0,0,412,0,449,0,0,412,0,449,0,0,412,0,0,0,0,447,0,
414,0,0,0,0,0,0,0,0,0,0,0,0,0,0,0,0,0,0,0,0,414,0,
0,0,0,441,448,0,0,441,442,0,443,0,443,0,442,441,0,448,0,441,0,0,0],

"it2":[],

"point1": [[11,0],[11,1],[5,1],[5,3],[17,3],[17,5],[11,5]],
"point2": [[11,0],[11,1],[5,1],[5,3],[17,3],[17,5],[11,5]],
"point3": [[2,0],[20,0],[20,5],[11,5]],
"point4": [[2,0],[20,0],[20,5],[11,5]],
"point5": [[11,0],[11,1],[17,1],[17,3],[5,3],[5,5],[11,5]],
"point6": [[11,0],[11,1],[17,1],[17,3],[5,3],[5,5],[11,5]],
"point7": [[20,0],[2,0],[2,5],[11,5]],
"point8": [[20,0],[2,0],[2,5],[11,5]]

}
