{
"row":23,
"col":7,
"isloop":0,
"datas":[2,2,2,1,1,1,1,1,1,1,1,1,1,1,1,1,1,1,1,1,2,1,1,
2,1,1,1,1,1,1,1,1,1,1,1,1,1,1,1,2,2,2,1,2,1,1,
2,1,2,2,2,2,2,2,2,2,2,2,2,2,2,1,2,2,2,1,2,1,2,
2,1,2,1,1,1,1,1,1,1,1,1,1,1,1,1,1,1,1,1,2,1,2,
2,1,2,1,2,2,2,1,2,2,2,0,2,2,2,2,2,2,2,2,2,1,2,
1,1,2,1,2,2,2,1,1,1,1,1,1,1,1,1,1,1,1,1,1,1,2,
1,1,2,1,1,1,1,1,1,1,1,1,1,1,1,1,1,1,1,1,2,2,2],

"it1":[442,449,0,0,0,0,0,0,0,0,0,0,0,0,0,0,0,0,0,0,446,0,0,
410,0,0,0,0,0,0,0,0,0,0,0,0,0,0,0,406,0,412,0,0,0,0,
0,0,412,0,401,448,0,403,447,0,412,0,449,0,0,0,0,0,0,0,444,0,445,
445,0,444,0,0,0,0,0,0,0,0,0,0,0,0,0,0,0,0,0,0,0,0,
0,0,0,0,0,406,0,0,0,449,0,0,412,447,0,403,448,0,401,0,412,0,0,
0,0,446,0,412,0,0,0,0,0,0,0,0,0,0,0,0,0,0,0,0,0,411,
0,0,0,0,0,0,0,0,0,0,0,0,0,0,0,0,0,0,0,0,449,0,442],

"it2":[0,0,410,0,0,0,0,0,0,0,0,0,0,0,0,0,0,0,0,0,0,0,0,
0,0,0,0,0,0,0,0,0,0,0,0,0,0,0,0,0,0,0,0,0,0,0,
0,0,0,0,0,0,0,0,0,0,0,0,0,0,0,0,0,0,0,0,0,0,0,
0,0,0,0,0,0,0,0,0,0,0,0,0,0,0,0,0,0,0,0,0,0,0,
0,0,0,0,0,0,0,0,0,0,0,0,0,0,0,0,0,0,0,0,0,0,0,
0,0,0,0,0,0,0,0,0,0,0,0,0,0,0,0,0,0,0,0,0,0,0,
0,0,0,0,0,0,0,0,0,0,0,0,0,0,0,0,0,0,0,0,411,0,0],

"point1": [[3,0],[19,0],[19,3],[11,3]],
"point2": [[3,0],[19,0],[19,3],[11,3]],
"point3": [[0,5],[0,6],[1,6],[1,1],[15,1],[15,3],[11,3]],
"point4": [[0,5],[0,6],[1,6],[1,1],[15,1],[15,3],[11,3]],
"point5": [[19,6],[3,6],[3,3],[11,3]],
"point6": [[19,6],[3,6],[3,3],[11,3]],
"point7": [[22,1],[22,0],[21,0],[21,5],[7,5],[7,3],[11,3]],
"point8": [[22,1],[22,0],[21,0],[21,5],[7,5],[7,3],[11,3]]

}
