{
"row":23,
"col":7,
"isloop":0,
"datas":[2,2,2,2,2,2,2,2,2,2,2,2,2,2,2,2,2,2,2,2,2,2,2,
2,2,1,1,1,1,1,1,1,1,1,1,1,1,1,1,1,1,1,1,1,2,2,
2,2,1,2,2,2,2,2,2,2,2,2,2,2,2,2,2,2,2,2,1,2,2,
2,2,1,1,1,1,1,1,1,1,1,1,1,1,1,1,1,1,1,1,1,2,2,
2,2,1,2,2,2,2,2,2,2,2,0,2,2,2,2,2,2,2,2,1,2,2,
2,2,1,1,1,1,1,1,1,1,1,1,1,1,1,1,1,1,1,1,1,2,2,
2,2,2,2,2,2,2,2,2,2,2,2,2,2,2,2,2,2,2,2,2,2,2],

"it1":[550,0,0,548,0,0,541,0,542,0,540,412,540,0,542,0,541,0,548,0,0,551,0,
0,0,0,0,0,0,0,0,0,0,0,0,0,0,0,0,0,0,0,0,0,0,0,
0,546,0,401,0,547,0,0,403,549,0,412,549,0,403,0,547,0,0,401,0,0,545,
545,0,0,0,0,0,0,0,0,0,0,0,0,0,0,0,0,0,0,0,0,546,0,
0,0,0,401,0,547,0,0,403,549,0,0,549,0,403,0,547,0,0,401,0,0,0,
551,0,0,0,0,0,0,0,0,0,0,0,0,0,0,0,0,0,0,0,0,550,0,
0,0,0,548,0,0,541,0,542,0,540,412,540,0,542,0,541,0,548,0,0,0,0],

"it2":[0,0,0,0,0,0,0,0,0,0,0,0,0,0,0,0,0,0,0,0,0,0,0,
0,410,0,0,0,0,0,0,0,0,0,0,0,0,0,0,0,0,0,0,0,411,0,
0,0,0,0,0,0,0,0,0,0,0,0,0,0,0,0,0,0,0,0,0,0,0,
0,410,0,0,0,0,0,0,0,0,0,0,0,0,0,0,0,0,0,0,0,411,0,
0,0,0,0,0,0,0,0,0,0,0,0,0,0,0,0,0,0,0,0,0,0,0,
0,410,0,0,0,0,0,0,0,0,0,0,0,0,0,0,0,0,0,0,0,411,0,
0,0,0,0,0,0,0,0,0,0,0,0,0,0,0,0,0,0,0,0,0,0,0],

"point1": [[20,5],[2,5],[2,3],[11,3]],
"point2": [[20,5],[2,5],[2,3],[11,3]],
"point3": [[20,1],[2,1],[2,3],[11,3]],
"point4": [[20,1],[2,1],[2,3],[11,3]],
"point5": [[2,1],[20,1],[20,3],[11,3]],
"point6": [[2,1],[20,1],[20,3],[11,3]],
"point7": [[2,5],[20,5],[20,3],[11,3]],
"point8": [[2,5],[20,5],[20,3],[11,3]]

}
