{
"row":23,
"col":7,
"isloop":0,
"datas":[2,1,1,1,1,1,2,1,1,1,1,1,1,1,1,1,1,1,1,1,1,1,2,
2,1,2,2,2,2,2,2,2,1,2,2,2,2,2,2,2,1,2,2,2,1,2,
1,1,2,2,2,2,2,2,2,1,2,2,2,2,2,2,2,1,2,2,2,1,1,
1,2,2,2,2,1,1,1,1,1,1,1,1,1,1,1,1,1,2,2,2,2,1,
1,1,2,2,2,1,2,2,2,2,2,0,2,1,2,2,2,2,2,2,2,1,1,
2,1,2,2,2,1,2,2,2,2,2,2,2,1,2,2,2,2,2,2,2,1,2,
2,1,1,1,1,1,1,1,1,1,1,1,1,1,1,1,2,1,1,1,1,1,2],

"it1":[477,0,0,0,0,0,410,0,0,0,0,0,0,0,0,0,0,0,0,0,0,0,411,
0,0,483,0,478,482,0,483,0,0,479,0,472,0,475,479,0,0,476,482,0,0,474,
0,0,0,0,0,0,0,0,0,0,471,412,471,480,0,0,471,0,0,0,0,0,0,
0,401,0,481,0,0,0,0,0,0,0,0,0,0,0,0,0,0,481,0,0,401,0,
0,0,482,0,476,0,471,0,480,0,412,0,412,0,483,0,482,0,478,483,0,0,0,
474,0,0,0,0,0,479,0,475,0,472,479,0,0,0,0,0,0,0,0,0,0,477,
410,0,0,0,0,0,0,0,0,0,0,0,0,0,0,0,411,0,0,0,0,0,0],

"it2":[],

"point1": [[5,0],[1,0],[1,2],[0,2],[0,4],[1,4],[1,6],[13,6],[13,3],[11,3]],
"point2": [[5,0],[1,0],[1,2],[0,2],[0,4],[1,4],[1,6],[13,6],[13,3],[11,3]],
"point3": [[7,0],[17,0],[17,3],[11,3]],
"point4": [[7,0],[17,0],[17,3],[11,3]],
"point5": [[17,6],[21,6],[21,4],[22,4],[22,2],[21,2],[21,0],[9,0],[9,3],[11,3]],
"point6": [[17,6],[21,6],[21,4],[22,4],[22,2],[21,2],[21,0],[9,0],[9,3],[11,3]],
"point7": [[15,6],[5,6],[5,3],[11,3]],
"point8": [[15,6],[5,6],[5,3],[11,3]]

}
