{
"row":23,
"col":7,
"isloop":0,
"datas":[2,2,2,2,2,2,2,2,2,2,2,1,2,2,2,2,2,2,2,2,2,2,2,
2,2,1,1,1,1,1,1,1,1,1,1,1,1,1,1,1,1,1,1,1,2,2,
2,2,1,2,2,1,2,2,1,2,2,2,2,2,1,2,2,1,2,2,1,2,2,
2,2,1,2,2,1,2,2,1,1,1,1,1,1,1,2,2,1,2,2,1,2,2,
2,2,1,2,2,1,2,2,1,2,2,2,2,2,1,2,2,1,2,2,1,2,2,
2,2,1,2,2,1,1,1,1,1,1,1,1,1,1,1,1,1,2,2,1,2,2,
2,2,2,2,2,2,2,2,2,2,2,0,2,2,2,2,2,2,2,2,2,2,2],

"it1":[451,0,0,448,0,0,0,447,0,0,0,0,0,0,447,0,0,0,448,0,0,451,0,
0,0,0,0,0,0,0,0,0,0,0,0,0,0,0,0,0,0,0,0,0,0,0,
0,441,0,450,0,0,406,0,0,412,0,412,0,412,0,0,0,0,450,0,0,441,0,
443,412,0,0,0,0,0,0,0,0,0,0,0,0,0,406,0,0,0,0,0,412,443,
449,0,0,401,0,0,0,0,0,412,0,412,0,412,0,0,0,0,0,401,0,449,0,
413,0,0,0,410,0,0,0,0,0,0,0,0,0,0,0,0,0,411,0,0,413,0,
0,0,0,448,0,0,0,447,0,0,442,0,442,0,447,0,0,0,448,0,0,0,0],

"it2":[0,0,0,0,0,0,0,0,0,0,0,0,0,0,0,0,0,0,0,0,0,0,0,
0,410,0,0,0,0,0,0,0,0,0,0,0,0,0,0,0,0,0,0,0,411,0,
0,0,0,0,0,0,0,0,0,0,0,0,0,0,0,0,0,0,0,0,0,0,0,
0,0,0,0,0,0,0,0,0,0,0,0,0,0,0,0,0,0,0,0,0,0,0,
0,0,0,0,0,0,0,0,0,0,0,0,0,0,0,0,0,0,0,0,0,0,0,
0,0,0,0,0,0,0,0,0,0,0,0,0,0,0,0,0,0,0,0,0,0,0,
0,0,0,0,0,0,0,0,0,0,0,0,0,0,0,0,0,0,0,0,0,0,0],

"point1": [[2,5],[2,1],[14,1],[14,5],[11,5]],
"point2": [[2,5],[2,1],[14,1],[14,5],[11,5]],
"point3": [[11,0],[11,1],[5,1],[5,5],[8,5],[8,3],[14,3],[14,5],[11,5]],
"point4": [[11,0],[11,1],[5,1],[5,5],[8,5],[8,3],[14,3],[14,5],[11,5]],
"point5": [[20,5],[20,1],[8,1],[8,5],[11,5]],
"point6": [[20,5],[20,1],[8,1],[8,5],[11,5]],
"point7": [[11,0],[11,1],[17,1],[17,5],[14,5],[14,3],[8,3],[8,5],[11,5]],
"point8": [[11,0],[11,1],[17,1],[17,5],[14,5],[14,3],[8,3],[8,5],[11,5]]

}
