{
"row":23,
"col":7,
"isloop":0,
"datas":[2,1,1,1,1,1,1,1,1,1,1,1,1,1,1,1,1,1,1,1,1,1,2,
2,1,1,2,2,2,2,2,2,2,2,2,2,2,2,2,2,2,2,2,1,1,2,
2,2,1,1,2,2,2,2,2,2,2,2,2,2,2,2,2,2,2,1,1,2,2,
2,2,2,1,1,1,1,1,1,1,1,1,1,1,1,1,1,1,1,1,2,2,2,
2,2,1,1,2,2,2,2,2,2,2,0,2,2,2,2,2,2,2,1,1,2,2,
2,1,1,2,2,2,2,2,2,2,2,2,2,2,2,2,2,2,2,2,1,1,2,
2,1,1,1,1,1,1,1,1,1,1,1,1,1,1,1,1,1,1,1,1,1,2],

"it1":[410,0,0,0,0,0,0,0,0,0,0,0,0,0,0,0,0,0,0,0,0,0,411,
401,0,0,404,434,0,427,430,424,0,432,412,432,426,0,428,0,434,0,0,0,0,401,
433,0,0,0,0,0,0,0,0,424,0,412,0,421,0,429,0,0,0,0,0,0,404,
0,0,412,0,0,0,0,0,0,0,0,0,0,0,0,0,0,0,0,0,412,433,0,
404,0,0,0,434,0,429,0,0,421,432,0,432,0,424,430,0,434,0,0,0,0,0,
401,0,0,0,0,0,0,428,426,0,0,412,0,424,0,0,427,0,0,404,0,0,401,
410,0,0,0,0,0,0,0,0,0,0,0,0,0,0,0,0,0,0,0,0,0,411],

"it2":[0,0,0,0,0,0,0,0,0,0,0,0,0,0,0,0,0,0,0,0,0,0,0,
0,0,0,904,0,0,0,0,0,0,0,0,0,0,0,0,0,0,0,0,0,0,0,
0,0,0,0,0,0,0,0,0,0,0,0,0,0,0,0,0,0,0,0,0,0,904,
0,0,0,0,0,0,0,0,0,0,0,0,0,0,0,0,0,0,0,0,0,0,0,
904,0,0,0,0,0,0,0,0,0,0,0,0,0,0,0,0,0,0,0,0,0,0,
0,0,0,0,0,0,0,0,0,0,0,0,0,0,0,0,0,0,0,904,0,0,0,
0,0,0,0,0,0,0,0,0,0,0,0,0,0,0,0,0,0,0,0,0,0,0],

"point1": [[21,6],[1,6],[1,5],[2,5],[2,4],[3,4],[3,3],[11,3]],
"point2": [[21,6],[1,6],[1,5],[2,5],[2,4],[3,4],[3,3],[11,3]],
"point3": [[1,6],[21,6],[21,5],[20,5],[20,4],[19,4],[19,3],[11,3]],
"point4": [[1,6],[21,6],[21,5],[20,5],[20,4],[19,4],[19,3],[11,3]],
"point5": [[1,0],[21,0],[21,1],[20,1],[20,2],[19,2],[19,3],[11,3]],
"point6": [[1,0],[21,0],[21,1],[20,1],[20,2],[19,2],[19,3],[11,3]],
"point7": [[21,0],[1,0],[1,1],[2,1],[2,2],[3,2],[3,3],[11,3]],
"point8": [[21,0],[1,0],[1,1],[2,1],[2,2],[3,2],[3,3],[11,3]]

}
