{
"row":23,
"col":7,
"isloop":0,
"datas":[2,2,2,2,2,2,2,2,2,2,2,0,2,2,2,2,2,2,2,2,2,2,2,
2,1,1,1,1,1,1,1,1,1,1,1,1,1,1,1,1,1,1,1,1,1,2,
2,1,2,2,2,2,2,2,2,2,2,1,2,2,2,2,2,2,2,2,2,1,2,
2,1,2,2,2,2,2,2,2,2,2,1,2,2,2,2,2,2,2,2,2,1,2,
2,1,2,2,2,2,2,2,2,2,2,1,2,2,2,2,2,2,2,2,2,1,2,
2,1,1,1,1,1,1,1,1,1,2,1,2,1,1,1,1,1,1,1,1,1,2,
2,2,2,2,2,2,2,2,2,2,2,0,2,2,2,2,2,2,2,2,2,2,2],

"it1":[0,0,0,0,0,0,0,0,0,0,0,0,0,0,0,0,0,0,0,0,0,0,0,
0,0,0,0,0,0,0,0,0,0,0,0,0,0,0,0,0,0,0,0,0,0,0,
0,0,0,0,0,0,414,0,0,0,412,0,412,0,414,0,0,0,0,0,0,0,0,
0,0,406,0,0,404,0,0,0,0,0,0,0,0,0,0,404,0,0,406,0,0,0,
0,0,0,0,403,0,0,0,0,0,0,0,0,0,0,0,0,0,403,0,0,0,0,
410,0,0,0,0,0,0,0,0,0,0,0,0,0,0,0,0,0,0,0,0,0,411,
0,0,0,0,0,0,0,0,0,0,0,0,0,0,0,0,0,0,0,0,0,0,0],

"it2":[],

"point1": [[9,5],[1,5],[1,1],[11,1],[11,5]],
"point2": [[9,5],[1,5],[1,1],[11,1],[11,5]],
"point3": [[13,5],[21,5],[21,1],[11,1],[11,5]],
"point4": [[13,5],[21,5],[21,1],[11,1],[11,5]]

}
