{
"row":13,
"col":7,
"isloop":0,
"datas":[2,2,2,2,2,2,2,2,2,2,2,2,2,
2,1,1,1,1,2,2,2,2,2,2,2,2,
2,1,2,1,1,2,2,2,2,2,2,2,2,
2,1,2,1,1,1,1,1,1,1,1,2,2,
2,1,1,1,1,2,2,2,2,2,0,2,2,
2,1,1,1,1,2,2,2,2,2,2,2,2,
2,2,2,2,2,2,2,2,2,2,2,2,2],

"it1":[421,429,0,429,0,434,0,422,0,423,430,432,430,
431,0,0,0,0,0,0,432,434,0,0,0,0,
0,0,432,0,0,426,0,0,0,0,429,0,423,
423,0,0,0,0,0,0,0,0,0,0,0,430,
431,0,0,0,0,426,0,432,434,0,0,421,0,
0,0,0,0,0,434,0,0,0,0,430,432,430,
0,429,0,426,0,0,0,429,0,423,0,0,0],

"it2":[],

"point1": [[1,5],[4,5],[4,4],[1,4],[1,1],[4,1],[4,2],[3,2],[3,3],[10,3]],
"point2": [[1,5],[4,5],[4,4],[1,4],[1,1],[4,1],[4,2],[3,2],[3,3],[10,3]]

}
