{
"row":23,
"col":7,
"isloop":0,
"iswood":1,
"datas":[2,2,2,2,1,1,1,1,1,1,1,1,1,1,1,1,1,1,1,1,1,1,1,
2,2,1,1,1,1,1,1,1,1,1,1,1,1,2,4,1,2,2,2,2,4,4,
2,2,1,2,1,2,2,2,2,1,2,4,2,1,2,2,1,2,2,2,2,4,4,
2,2,1,1,1,1,1,1,1,1,1,1,1,1,1,1,1,1,1,2,2,4,4,
2,2,2,2,1,1,1,1,1,1,1,1,2,2,2,2,1,2,1,2,2,4,4,
2,2,2,2,2,2,2,2,2,1,2,0,2,2,2,2,1,2,1,2,2,4,4,
1,1,1,1,1,1,1,1,1,1,1,1,1,1,1,1,1,1,1,2,2,4,4],

"it1":[406,0,627,0,0,0,0,0,0,0,0,0,0,0,0,0,0,0,0,0,0,0,0,
0,0,0,0,0,0,0,0,0,0,0,0,0,0,625,0,0,406,0,630,0,0,0,
629,0,0,621,0,628,0,0,0,0,0,0,401,0,0,621,0,0,0,0,0,0,0,
0,0,0,0,0,0,0,0,0,0,0,0,0,0,0,0,0,0,0,627,0,0,0,
630,0,0,621,0,0,0,0,0,0,0,0,0,624,0,0,0,625,0,627,0,0,0,
0,0,627,0,626,0,0,628,0,0,401,0,0,0,0,621,0,0,0,629,0,0,0,
0,0,0,0,0,0,0,0,0,0,0,0,0,0,0,0,0,0,0,0,0,0,0],

"it2":[0,0,0,0,0,0,0,0,0,0,0,0,0,0,0,0,0,0,0,0,0,0,0,
0,0,0,0,0,0,0,0,0,0,0,0,0,0,0,0,0,0,0,0,0,0,0,
0,0,0,0,0,0,0,0,0,0,0,0,0,0,0,0,0,0,0,0,0,0,0,
0,410,0,0,0,0,0,0,0,0,0,0,0,0,0,0,0,0,0,411,0,0,0,
0,0,0,0,0,0,0,0,0,0,0,0,0,0,0,0,0,0,0,0,0,0,0,
0,0,0,0,0,0,0,0,0,0,0,0,0,0,0,0,0,0,0,0,0,0,0,
0,0,0,0,0,0,0,0,0,0,0,0,0,0,0,0,0,0,0,0,0,0,0],

"point1": [[2,1],[2,3],[13,3],[13,1],[2,1],[2,3],[11,3],[11,4]],
"point2": [[2,1],[2,3],[13,3],[13,1],[2,1],[2,3],[11,3],[11,4]],
"point3": [[0,6],[18,6],[18,3],[11,3],[11,4]],
"point4": [[0,6],[18,6],[18,3],[11,3],[11,4]],
"point5": [[16,0],[9,0],[9,6],[16,6],[16,0],[9,0],[9,4],[11,4]],
"point6": [[16,0],[9,0],[9,6],[16,6],[16,0],[9,0],[9,4],[11,4]],
"point7": [[22,0],[4,0],[4,3],[11,3],[11,4]],
"point8": [[22,0],[4,0],[4,3],[11,3],[11,4]]

}
