{
"row":13,
"col":7,
"isloop":0,
"datas":[2,2,2,2,2,2,2,2,2,2,2,2,2,
2,2,2,2,2,2,1,1,1,1,1,2,2,
2,2,2,2,2,2,1,2,2,2,0,2,2,
2,2,1,1,1,1,1,2,2,2,2,2,2,
2,2,1,2,2,1,1,1,2,2,2,2,2,
2,2,1,2,2,1,2,1,2,2,2,2,2,
2,2,2,2,2,1,1,1,2,2,2,2,2],

"it1":[431,426,0,427,429,0,423,429,0,427,426,0,430,
0,423,427,0,433,0,0,0,0,0,0,423,0,
423,432,426,0,0,0,0,427,434,0,0,426,0,
431,0,0,0,0,0,0,423,0,0,427,431,430,
0,430,0,425,425,0,0,0,433,0,430,0,0,
431,0,0,425,425,0,7011,0,0,0,0,426,0,
0,426,0,426,0,0,0,0,429,0,426,0,421],

"it2":[0,0,0,0,0,0,0,0,0,0,0,0,0,
0,0,0,0,0,0,0,0,0,0,0,0,0,
0,0,0,0,3011,0,0,0,0,0,0,0,0,
0,0,0,0,0,0,0,0,0,0,0,0,0,
0,0,0,7011,7011,0,0,0,0,0,0,0,0,
0,0,0,7011,7011,0,0,0,0,0,0,0,0,
0,0,0,0,0,0,0,0,0,0,0,0,0],

"point1": [[2,5],[2,3],[5,3],[5,6],[7,6],[7,4],[6,4],[6,1],[10,1]],
"point2": [[2,5],[2,3],[5,3],[5,6],[7,6],[7,4],[6,4],[6,1],[10,1]]

}
