{
"row":13,
"col":7,
"isloop":0,
"destroyed1":[[9,4],[8,4]],
"destroyed2":[[9,4],[8,4]],
"datas":[2,2,2,2,2,2,2,2,2,2,2,2,2,
2,2,1,1,1,1,1,1,1,1,1,2,2,
2,2,1,2,2,2,2,2,2,2,0,2,2,
2,2,1,2,2,2,2,2,2,2,2,2,2,
2,2,1,1,1,1,1,1,1,2,2,2,2,
2,2,2,2,2,2,2,2,2,2,2,2,2,
2,2,2,2,2,2,2,2,2,2,2,2,2],

"it1":[431,421,422,0,421,426,0,421,422,0,421,421,431,
0,430,0,0,0,0,0,0,0,0,0,430,0,
427,0,0,434,0,0,429,0,430,432,0,0,421,
426,0,0,0,0,429,0,428,0,0,425,430,432,
427,432,0,0,0,0,0,0,0,400,0,0,0,
431,0,421,426,0,426,0,422,0,0,0,423,431,
0,421,422,0,421,426,0,421,422,0,421,421,0],

"it2":[0,0,0,0,0,0,0,0,0,0,0,0,0,
0,0,0,0,0,0,0,0,0,0,0,0,0,
0,0,0,0,0,0,0,0,0,0,0,0,0,
0,0,0,0,0,0,0,0,0,0,2011,0,0,
0,0,0,0,0,0,0,0,0,0,0,0,0,
0,0,0,0,0,0,0,0,0,0,0,0,0,
0,0,0,0,0,0,0,0,0,0,0,0,0],

"point1": [[8,4],[2,4],[2,1],[10,1]],
"point2": [[8,4],[2,4],[2,1],[10,1]]

}
