{
"row":23,
"col":7,
"isloop":0,
"datas":[2,2,1,1,1,1,1,1,1,1,1,1,1,1,1,1,1,1,1,1,1,2,2,
2,2,1,1,1,1,1,1,1,1,1,1,1,1,1,1,1,1,1,1,1,2,2,
2,2,2,2,2,2,2,2,2,2,2,1,2,2,2,2,2,2,2,2,2,2,2,
2,2,1,1,1,1,1,1,1,1,1,1,1,1,1,1,1,1,1,1,1,2,2,
2,2,1,1,1,1,1,1,1,1,1,1,1,1,1,1,1,1,1,1,1,2,2,
2,2,2,2,2,2,2,2,2,2,2,1,2,2,2,2,2,2,2,2,2,2,2,
2,2,2,2,2,2,2,2,2,2,2,0,2,2,2,2,2,2,2,2,2,2,2],

"it1":[413,0,0,0,0,0,0,0,0,0,0,0,0,0,0,0,0,0,0,0,0,413,0,
0,0,0,0,0,0,0,0,0,0,0,0,0,0,0,0,0,0,0,0,0,0,0,
769,0,0,412,412,0,412,412,0,412,412,0,412,412,0,412,412,0,412,412,0,769,0,
0,0,0,0,0,0,0,0,0,0,0,0,0,0,0,0,0,0,0,0,0,0,0,
0,410,0,0,0,0,0,0,0,0,0,0,0,0,0,0,0,0,0,0,0,411,0,
770,0,401,763,0,0,765,767,0,764,403,0,403,764,767,0,765,0,0,763,401,770,0,
0,0,0,0,768,0,0,0,0,0,0,0,0,0,0,0,0,768,0,0,0,0,0],

"it2":[],

"point1": [[2,4],[20,4],[20,3],[11,3],[11,5]],
"point2": [[2,3],[20,3],[20,4],[11,4],[11,5]],
"point3": [[2,1],[20,1],[20,0],[11,0],[11,5]],
"point4": [[2,0],[20,0],[20,1],[11,1],[11,5]],
"point5": [[20,4],[2,4],[2,3],[11,3],[11,5]],
"point6": [[20,3],[2,3],[2,4],[11,4],[11,5]],
"point7": [[20,1],[2,1],[2,0],[11,0],[11,5]],
"point8": [[20,0],[2,0],[2,1],[11,1],[11,5]]

}
