{
"row":13,
"col":7,
"isloop":0,
"destroyed1":[[2,5],[4,6]],
"destroyed2":[[2,5],[4,6]],
"destroyed3":[[2,5],[2,4]],
"destroyed4":[[2,5],[2,4]],
"datas":[2,2,2,1,1,1,1,1,1,1,2,2,2,
2,2,1,1,2,2,2,2,2,1,1,2,2,
2,2,1,2,2,2,2,2,2,0,1,2,2,
2,2,1,2,2,2,2,2,2,2,1,2,2,
2,2,1,2,2,2,2,2,2,2,1,2,2,
2,2,2,2,2,2,2,2,2,1,1,2,2,
2,2,2,2,1,1,1,1,1,1,2,2,2],

"it1":[443,447,0,0,0,0,0,0,0,0,0,447,0,
450,0,0,0,448,0,443,443,446,0,0,441,0,
0,0,0,444,443,449,0,445,0,0,0,444,446,
446,445,0,0,443,445,403,0,443,444,0,0,0,
0,0,0,443,446,0,449,0,443,0,0,450,0,
451,0,400,0,0,443,443,448,0,0,0,0,0,
0,0,0,0,0,0,0,0,0,0,447,0,442],

"it2":[0,0,0,0,0,0,0,0,0,0,0,0,0,
0,0,0,0,0,0,0,0,2011,0,0,0,0,
0,0,0,2011,0,0,0,0,0,0,0,0,0,
0,0,0,0,0,0,0,0,0,0,0,0,0,
0,0,0,0,0,0,0,0,0,2011,0,0,0,
0,0,0,0,0,0,0,0,0,0,0,0,0,
0,0,0,0,0,0,0,0,0,0,0,0,0],

"point1": [[4,6],[9,6],[9,5],[10,5],[10,1],[9,1]],
"point2": [[4,6],[9,6],[9,5],[10,5],[10,1],[9,1]],
"point3": [[2,4],[2,1],[3,1],[3,0],[9,0],[9,1]],
"point4": [[2,4],[2,1],[3,1],[3,0],[9,0],[9,1]]

}
