{
"row":13,
"col":7,
"isloop":0,
"datas":[2,2,3,3,3,3,3,3,3,3,3,3,1,
3,3,3,2,2,2,2,2,2,2,2,3,0,
2,2,3,2,2,2,2,3,2,3,3,3,3,
2,2,3,2,3,3,2,2,2,2,2,2,3,
2,2,3,2,2,2,3,3,3,2,2,2,3,
1,3,3,3,3,3,3,3,3,2,3,3,3,
2,2,2,2,2,2,2,2,2,2,2,2,2],

"it1":[442,441,0,0,0,0,0,0,0,0,0,0,0,
0,0,0,451,0,451,0,449,0,447,0,0,0,
442,441,0,0,0,0,0,0,445,0,0,0,0,
406,0,0,443,0,0,447,0,0,443,406,0,0,
0,0,0,401,448,0,0,0,0,441,0,0,0,
0,0,0,0,0,0,0,0,0,441,0,0,0,
449,0,449,0,443,449,0,443,449,0,443,449,0],

"it2":[],

"point1": [[0,5],[12,0]],
"point2": [[0,5],[12,0]]

}
