{
"row":13,
"col":7,
"isloop":1,
"datas":[2,2,2,2,2,2,2,2,2,2,2,2,2,
1,1,1,1,1,1,1,1,1,1,1,1,1,
1,2,2,2,2,2,2,2,2,2,2,2,1,
1,2,2,2,2,2,2,2,2,2,2,2,1,
1,2,2,2,2,2,2,2,2,2,2,2,1,
1,1,1,1,1,1,1,1,1,1,1,1,1,
2,2,2,2,2,2,2,2,2,2,2,2,2],

"it1":[442,401,447,0,449,0,442,449,0,448,0,401,441,
0,0,0,0,0,0,0,0,0,0,0,0,0,
0,450,0,449,0,441,449,0,451,0,447,0,0,
0,0,0,451,0,0,401,0,0,0,450,0,0,
0,447,0,0,0,449,0,441,449,0,0,0,0,
0,0,0,0,0,0,0,0,0,0,0,0,0,
441,401,448,0,449,0,442,449,0,447,0,401,442],

"it2":[],

"point1": [[0,5],[12,5],[12,1],[0,1],[0,5]],
"point2": [[12,1],[0,1],[0,5],[12,5],[12,1]]

}
