{
"row":13,
"col":7,
"isloop":0,
"datas":[2,1,1,1,1,1,1,1,1,1,1,1,2,
2,1,2,1,1,1,1,1,1,1,1,1,2,
2,1,2,1,2,2,2,2,2,2,2,1,2,
2,1,2,1,2,2,2,2,2,2,2,1,2,
2,1,2,1,1,1,1,1,1,1,2,0,2,
2,1,1,1,1,1,1,1,1,1,1,1,2,
2,2,2,2,2,2,2,2,2,2,2,2,2],

"it1":[401,0,0,0,0,0,0,0,0,0,0,0,0,
444,0,404,0,0,0,0,0,0,0,0,0,446,
0,0,444,0,451,0,406,0,450,0,443,0,0,
446,0,0,0,0,0,0,0,0,0,401,0,445,
0,0,404,0,0,0,0,0,0,0,404,0,0,
443,0,0,0,0,0,0,0,0,0,0,0,443,
0,449,0,442,448,0,443,448,0,442,449,0,401],

"it2":[0,0,0,0,0,0,0,0,0,0,0,0,0,
0,0,1100,0,0,0,0,0,0,0,0,0,0,
0,0,0,0,0,0,0,0,0,0,0,0,0,
0,0,0,0,0,0,0,0,0,0,0,0,0,
0,0,1100,0,0,0,0,0,0,0,1100,0,0,
0,0,0,0,0,0,0,0,0,0,0,0,0,
0,0,0,0,0,0,0,0,0,0,0,0,0],

"point1": [[11,5],[1,5],[1,0],[11,0],[11,3]],
"point2": [[9,4],[3,4],[3,1],[11,1],[11,3]]

}
