{
"row":13,
"col":7,
"isloop":0,
"datas":[2,2,2,2,2,2,2,2,2,2,2,2,2,
3,2,2,3,2,2,3,2,2,3,2,2,3,
2,2,2,2,2,2,2,2,2,2,2,2,2,
1,3,3,3,3,3,3,3,3,3,3,3,1,
2,2,2,2,2,2,2,2,2,2,2,2,0,
3,2,2,3,2,2,3,2,2,3,2,2,3,
2,2,2,2,2,2,2,2,2,2,2,2,2],

"it1":[401,401,401,401,401,401,401,401,401,401,401,401,401,
0,447,0,0,401,404,0,404,401,0,448,0,0,
449,0,449,0,449,0,449,0,449,0,449,0,443,
0,0,0,0,0,0,0,0,0,0,0,0,0,
449,0,449,0,449,0,449,0,449,0,449,0,0,
0,448,0,0,401,404,0,404,401,0,447,0,0,
401,401,401,401,401,401,401,401,401,401,401,401,401],

"it2":[0,0,0,0,0,0,0,0,0,0,0,0,0,
0,0,0,0,0,1100,0,1100,0,0,0,0,0,
0,0,0,0,0,0,0,0,0,0,0,0,0,
0,0,0,0,0,0,0,0,0,0,0,0,0,
0,0,0,0,0,0,0,0,0,0,0,0,0,
0,0,0,0,0,1100,0,1100,0,0,0,0,0,
0,0,0,0,0,0,0,0,0,0,0,0,0],

"point1": [[0,3],[12,3]],
"point2": [[0,3],[12,3]]

}
