{
"row":13,
"col":7,
"isloop":1,
"datas":[2,2,2,2,2,2,1,1,1,1,1,1,2,
2,2,2,2,2,2,1,2,2,2,2,1,2,
2,2,2,2,2,2,1,2,2,2,2,1,2,
2,1,1,1,1,1,1,1,1,1,1,1,2,
2,1,2,2,2,2,1,2,2,2,2,2,2,
2,1,2,2,2,2,1,2,2,2,2,2,2,
2,1,1,1,1,1,1,2,2,2,2,2,2],

"it1":[447,0,449,0,446,444,0,0,0,0,0,0,441,
448,0,444,445,0,0,0,0,401,450,0,0,401,
449,0,0,0,448,0,0,443,443,0,0,0,446,
446,0,0,0,0,0,0,0,0,0,0,0,0,
0,0,450,0,443,443,0,448,0,445,444,449,0,
401,0,0,0,401,0,0,444,445,0,0,448,0,
441,0,0,0,0,0,0,0,0,449,0,447,0],

"it2":[0,0,0,0,0,0,0,0,0,0,0,0,0,
0,0,0,0,0,0,0,0,0,0,0,0,0,
0,0,0,0,0,0,0,412,0,0,0,0,0,
0,0,0,0,0,0,0,0,0,0,0,0,0,
0,0,0,0,0,412,0,0,0,0,0,0,0,
0,0,0,0,0,0,0,0,0,0,0,0,0,
0,0,0,0,0,0,0,0,0,0,0,0,0],

"point1": [[1,6],[6,6],[6,0],[11,0],[11,3],[1,3],[1,6]],
"point2": [[1,6],[6,6],[6,0],[11,0],[11,3],[1,3],[1,6]]

}
