{
"row":13,
"col":7,
"isloop":0,
"datas":[2,2,2,2,2,1,1,1,1,1,2,2,2,
2,2,2,2,2,1,2,2,2,1,2,2,2,
2,2,2,2,2,1,2,2,2,1,2,2,2,
1,1,1,1,2,1,1,1,2,1,1,1,1,
2,2,2,1,2,2,0,1,2,2,2,2,2,
2,2,2,1,2,2,2,1,2,2,2,2,2,
2,2,2,1,1,1,1,1,2,2,2,2,2],

"it1":[448,0,449,0,444,0,0,0,0,0,449,0,401,
414,0,451,0,0,0,401,450,0,0,446,414,0,
0,0,0,0,445,0,0,0,0,0,0,0,0,
0,0,0,0,0,0,0,0,445,0,0,0,0,
414,0,446,0,450,0,0,0,0,451,0,414,0,
0,0,0,0,0,0,0,0,444,0,0,0,0,
401,449,0,0,0,0,0,0,0,449,0,448,0],

"it2":[0,0,0,0,403,0,0,0,0,0,0,0,0,
0,0,0,0,403,0,0,0,403,0,0,0,0,
0,0,0,0,403,0,0,0,403,0,0,0,0,
0,0,0,0,403,0,0,0,403,0,0,0,0,
0,0,0,0,403,0,0,0,403,0,0,0,0,
0,0,0,0,403,0,0,0,403,0,0,0,0,
0,0,0,0,0,0,0,0,403,0,0,0,0],

"point1": [[0,3],[3,3],[3,6],[7,6],[7,3],[6,3]],
"point2": [[0,3],[3,3],[3,6],[7,6],[7,3],[6,3]],
"point3": [[12,3],[9,3],[9,0],[5,0],[5,3],[6,3]],
"point4": [[12,3],[9,3],[9,0],[5,0],[5,3],[6,3]]

}
