{
"row":13,
"col":7,
"isloop":0,
"destroyed1":[[0,0],[2,0]],
"destroyed2":[[0,0],[2,0]],
"datas":[2,2,1,2,2,2,2,2,2,2,2,3,1,
2,2,3,2,2,2,2,3,3,3,3,3,0,
2,3,3,2,2,3,3,3,2,2,2,3,3,
2,3,2,3,3,3,2,2,2,2,2,3,2,
2,3,3,3,2,2,2,2,2,2,2,3,2,
2,2,2,2,2,2,2,2,2,2,2,3,2,
2,2,2,2,2,2,2,2,2,2,2,3,1],

"it1":[400,0,0,446,401,412,441,412,443,412,442,0,0,
0,0,0,0,449,0,410,0,0,0,0,0,0,
446,0,0,412,410,0,0,0,443,446,442,0,0,
0,0,410,0,0,0,441,444,443,0,442,0,441,
410,0,0,0,442,445,441,0,443,401,442,0,441,
413,0,443,444,442,0,441,401,443,401,442,0,441,
0,0,443,0,442,401,441,401,443,401,442,0,0],

"it2":[],

"point1": [[2,0],[12,0]],
"point2": [[2,0],[12,0]],
"point3": [[12,6],[12,0]],
"point4": [[12,6],[12,0]]

}
