{
"row":13,
"col":7,
"isloop":0,
"destroyed1":[[0,5],[2,5]],
"destroyed2":[[3,5],[5,5]],
"destroyed3":[[8,5],[7,5]],
"destroyed4":[[11,5],[10,5]],
"datas":[2,2,3,3,3,3,1,3,3,3,3,2,2,
2,2,3,2,2,3,0,3,2,2,3,2,2,
2,3,3,2,3,3,2,3,3,2,3,3,2,
2,3,2,2,3,2,2,2,3,2,2,3,2,
2,3,3,2,3,3,2,3,3,2,3,3,2,
2,2,1,2,2,1,3,1,2,2,1,2,2,
2,2,2,2,2,2,2,2,2,2,2,2,2],

"it1":[448,0,0,0,0,0,0,0,0,0,0,448,0,
449,0,0,449,0,0,0,0,449,0,0,449,0,
401,0,0,401,0,0,401,0,0,401,0,0,401,
403,0,401,403,0,401,403,401,0,403,401,0,403,
401,0,0,401,0,0,401,0,0,401,0,0,401,
408,0,0,408,0,0,0,0,408,0,0,400,0,
0,0,442,0,0,443,442,443,0,0,442,0,0],

"it2":[],

"point1": [[2,5],[6,0]],
"point2": [[5,5],[6,0]],
"point3": [[7,5],[6,0]],
"point4": [[10,5],[6,0]]

}
