{
"row":13,
"col":7,
"isloop":0,
"datas":[2,2,2,2,2,2,2,2,2,2,2,2,2,
1,2,1,1,1,2,2,2,2,2,2,2,2,
1,2,1,2,1,2,2,2,2,2,2,2,2,
1,1,1,2,1,1,1,1,1,2,1,1,1,
2,2,2,2,2,2,2,2,1,2,1,2,1,
2,2,2,2,2,2,2,2,1,1,1,2,1,
2,2,2,2,2,2,2,2,2,2,2,2,0],

"it1":[509,0,508,0,509,0,502,506,510,0,503,507,0,
0,503,0,0,0,511,0,0,0,0,507,0,506,
0,404,0,506,0,0,0,503,404,0,508,0,0,
0,0,0,0,0,0,0,0,0,504,0,0,0,
511,0,506,501,404,505,511,0,0,0,0,501,0,
0,0,0,510,0,0,0,0,0,0,0,504,0,
508,0,502,0,0,507,0,508,0,509,0,0,0],

"it2":[0,0,0,0,0,0,0,0,0,0,0,0,0,
0,0,0,0,0,0,0,0,0,0,0,0,0,
0,1100,0,0,0,0,0,0,1100,0,0,0,0,
0,0,0,0,0,0,0,0,0,0,0,0,0,
0,0,0,0,1100,0,0,0,0,0,0,0,0,
0,0,0,0,0,0,0,0,0,0,0,0,0,
0,0,0,0,0,0,0,0,0,0,0,0,0],

"point1": [[0,1],[0,3],[2,3],[2,1],[4,1],[4,3],[8,3],[8,5],[10,5],[10,3],[12,3],[12,5]],
"point2": [[0,1],[0,3],[2,3],[2,1],[4,1],[4,3],[8,3],[8,5],[10,5],[10,3],[12,3],[12,5]]

}
