{
"row":13,
"col":7,
"isloop":0,
"datas":[2,2,1,1,1,1,1,1,1,1,1,2,2,
2,2,1,1,1,1,1,1,1,1,1,2,2,
2,2,1,2,2,2,2,2,2,2,2,2,2,
2,1,1,1,1,1,1,1,1,1,1,1,1,
2,2,1,2,2,2,2,2,2,2,2,2,0,
2,2,1,1,1,1,1,1,1,1,1,2,2,
2,2,1,1,1,1,1,1,1,1,1,2,2],

"it1":[417,410,0,0,0,0,0,0,0,0,0,450,0,
451,0,0,0,0,0,0,0,0,0,0,0,0,
0,0,0,443,449,0,442,448,0,449,0,0,0,
410,0,0,0,0,0,0,0,0,0,0,0,0,
401,446,0,443,449,0,442,448,0,449,0,6011,0,
446,0,0,0,0,0,0,0,0,0,0,450,0,
0,410,0,0,0,0,0,0,0,0,0,0,0],

"it2":[],

"point1": [[2,6],[10,6],[10,5],[2,5],[2,3],[12,3]],
"point2": [[2,6],[10,6],[10,5],[2,5],[2,3],[12,3]],
"point3": [[2,0],[10,0],[10,1],[2,1],[2,3],[12,3]],
"point4": [[2,0],[10,0],[10,1],[2,1],[2,3],[12,3]],
"point5": [[1,3],[12,3]]

}
