{
"row":13,
"col":7,
"isloop":0,
"datas":[2,2,1,1,1,1,1,1,1,1,1,1,1,
2,2,0,1,1,1,1,1,2,2,2,2,1,
2,2,1,1,2,1,2,1,2,2,2,2,1,
2,2,1,2,2,1,2,1,2,2,2,2,1,
2,1,1,2,2,1,1,1,2,2,2,2,1,
2,1,2,2,2,1,2,2,2,2,2,2,1,
2,1,1,1,1,1,2,2,2,2,2,2,1],

"it1":[406,0,0,0,0,0,0,0,0,0,0,0,0,
0,0,0,0,0,0,0,0,506,404,511,0,0,
508,0,0,0,506,0,506,0,0,502,0,0,0,
505,501,0,501,0,0,0,0,500,508,0,505,0,
0,0,0,510,0,0,0,0,508,0,504,0,0,
506,0,501,0,0,0,511,0,0,501,0,500,0,
0,0,0,0,0,0,0,0,507,0,507,0,0],

"it2":[0,0,0,0,0,0,0,0,0,0,0,0,0,
0,0,0,0,0,0,0,0,0,1100,0,0,0,
0,0,0,0,2021,0,2021,0,0,0,0,0,0,
0,0,0,0,0,0,0,0,0,0,0,0,0,
0,0,0,0,0,0,0,0,0,0,0,0,0,
0,0,0,0,0,0,0,0,0,0,0,0,0,
0,0,0,0,0,0,0,0,0,0,0,0,0],

"point1": [[5,3],[5,1],[3,1],[3,2],[2,2],[2,4],[1,4],[1,6],[5,6],[5,4],[7,4],[7,1],[6,1],[6,0],[2,0]],
"point2": [[5,3],[5,1],[3,1],[3,2],[2,2],[2,4],[1,4],[1,6],[5,6],[5,4],[7,4],[7,1],[6,1],[6,0],[2,0]],
"point3": [[12,6],[12,0],[2,0]],
"point4": [[12,6],[12,0],[2,0]]

}
