{
"row":13,
"col":7,
"isloop":1,
"datas":[2,2,1,1,1,1,1,1,1,1,1,1,1,
2,1,1,2,2,2,2,2,2,2,2,2,1,
2,1,1,1,1,1,1,1,1,1,1,1,1,
2,2,1,1,2,2,2,2,2,2,2,1,1,
2,2,1,1,1,1,1,1,1,1,1,1,1,
2,2,1,1,1,1,1,1,1,1,1,1,1,
2,2,2,2,2,2,2,2,2,2,2,2,2],

"it1":[504,500,0,0,0,0,0,0,0,0,0,0,0,
0,0,0,404,501,404,503,401,0,404,501,404,0,
0,0,0,0,0,0,0,0,0,0,0,0,0,
0,404,0,0,404,508,0,404,508,0,404,0,0,
507,0,0,0,0,0,0,0,0,0,0,0,0,
510,0,0,0,0,0,0,0,0,0,0,0,0,
0,0,0,401,503,404,508,0,404,503,401,0,425],

"it2":[0,0,0,0,0,0,0,0,0,0,0,0,0,
0,0,0,1020,0,1040,0,0,0,1040,0,1040,0,
0,0,0,0,0,0,0,0,0,0,0,0,0,
0,1050,0,0,1020,0,0,1040,0,0,1020,0,0,
0,0,0,0,0,0,0,0,0,0,0,0,0,
0,0,0,0,0,0,0,0,0,0,0,0,0,
0,0,0,0,0,1040,0,0,1040,0,0,0,6011],

"point1": [[12,4],[3,4],[3,2],[11,2],[11,3],[12,3],[12,0],[2,0],[2,1],[1,1],[1,2],[2,2],[2,5],[12,5],[12,4]],
"point2": [[12,4],[3,4],[3,2],[11,2],[11,3],[12,3],[12,0],[2,0],[2,1],[1,1],[1,2],[2,2],[2,5],[12,5],[12,4]]

}
