{
"row":13,
"col":7,
"isloop":0,
"datas":[2,2,2,2,2,2,2,2,2,2,1,1,1,
2,2,2,2,2,2,2,2,2,2,0,2,1,
2,1,1,1,1,1,1,1,1,1,1,2,1,
2,1,1,1,1,2,2,2,2,2,1,2,1,
2,2,2,2,2,2,2,2,2,2,1,1,1,
2,2,2,2,2,2,2,2,2,2,2,1,1,
2,2,2,2,2,2,2,2,2,2,2,2,2],

"it1":[500,506,401,406,0,401,507,0,508,0,0,0,0,
500,0,503,0,0,401,401,502,509,0,0,0,0,
404,0,0,0,0,0,0,0,0,0,0,505,0,
506,0,0,0,0,406,0,401,502,503,0,0,0,
0,511,0,404,401,0,0,511,0,506,0,0,0,
502,0,0,510,0,401,401,0,0,0,503,0,0,
507,0,502,0,0,501,503,508,0,503,509,0,500],

"it2":[0,0,0,0,0,0,0,0,0,0,0,0,0,
0,0,0,0,0,0,0,0,0,0,0,0,0,
1100,0,0,0,0,0,0,0,0,0,0,0,0,
0,0,0,0,0,0,0,0,0,0,0,0,0,
0,0,0,1100,0,0,0,0,0,0,0,0,0,
0,0,0,0,0,0,0,0,0,0,0,0,0,
0,0,0,0,0,0,0,0,0,0,0,0,0],

"point1": [[4,3],[1,3],[1,2],[10,2],[10,4],[11,4],[11,5],[12,5],[12,0],[10,0]],
"point2": [[4,3],[1,3],[1,2],[10,2],[10,4],[11,4],[11,5],[12,5],[12,0],[10,0]]

}
