{
"row":13,
"col":7,
"isloop":0,
"datas":[2,2,2,2,2,2,2,2,2,2,1,1,2,
2,2,2,2,2,2,2,2,1,1,1,1,2,
2,2,2,2,2,2,1,1,1,2,2,1,2,
2,2,2,2,1,1,1,2,2,2,2,1,2,
2,2,1,1,1,2,1,1,1,1,1,1,2,
2,1,1,2,2,2,0,2,2,2,2,2,2,
2,2,2,2,2,2,2,2,2,2,2,2,2],

"it1":[426,0,426,0,421,423,434,0,429,0,0,0,430,
430,426,0,421,434,0,0,0,0,0,0,0,0,
0,421,422,0,0,0,0,0,0,434,0,0,430,
422,0,426,0,0,0,0,422,0,0,0,0,0,
421,421,0,0,0,0,0,0,0,0,0,0,430,
0,0,0,0,421,423,0,422,0,430,421,423,0,
6011,0,421,428,427,421,423,426,0,0,421,426,0],

"it2":[0,0,0,0,0,0,0,0,0,0,0,0,0,
0,0,0,0,0,0,5011,5011,0,0,0,0,0,
0,0,0,0,7013,7013,0,0,0,5011,5011,0,0,
0,0,0,0,0,0,0,0,0,0,0,0,0,
0,0,0,0,0,0,0,0,0,0,0,0,0,
0,0,0,0,0,0,0,0,0,0,0,0,0,
0,0,0,0,0,0,0,0,0,0,0,0,0],

"point1": [[1,5],[2,5],[2,4],[4,4],[4,3],[6,3],[6,2],[8,2],[8,1],[10,1],[10,0],[11,0],[11,4],[6,4]],
"point2": [[1,5],[2,5],[2,4],[4,4],[4,3],[6,3],[6,2],[8,2],[8,1],[10,1],[10,0],[11,0],[11,4],[6,4]]

}
