{
"row":13,
"col":7,
"isloop":0,
"datas":[1,1,1,1,1,1,2,1,1,1,1,1,1,
1,2,1,1,1,1,2,1,2,2,2,2,1,
1,1,1,1,2,2,2,1,2,1,1,1,1,
2,1,1,1,1,1,1,1,2,1,2,2,2,
2,0,1,1,1,1,1,1,2,1,1,1,1,
2,2,1,1,2,2,2,1,2,1,1,1,1,
2,2,1,1,2,2,2,1,1,1,2,2,2],

"it1":[0,0,0,0,0,0,404,0,0,0,0,0,0,
0,401,0,0,0,0,506,0,508,0,507,0,0,
0,0,0,0,509,0,0,0,505,0,0,0,0,
506,0,0,0,0,0,0,0,0,0,507,0,0,
0,0,0,0,0,0,0,0,504,0,0,0,0,
510,0,0,0,511,0,404,0,0,0,0,0,0,
0,0,0,0,0,0,503,0,0,0,509,0,401],

"it2":[0,0,0,0,0,0,1100,0,0,0,0,0,0,
0,0,0,0,0,0,0,0,0,0,0,0,0,
0,0,0,0,0,0,0,0,0,0,0,0,0,
0,0,0,0,0,0,0,0,0,0,0,0,0,
0,0,0,0,0,0,0,0,0,0,0,0,0,
0,0,0,0,0,0,1100,0,0,0,0,0,0,
0,0,0,0,0,0,0,0,0,0,0,0,0],

"point1": [[3,2],[3,3],[7,3],[7,0],[12,0],[12,2],[9,2],[9,4],[12,4],[12,5],[9,5],[9,6],[7,6],[7,4],[3,4],[3,6],[2,6],[2,1],[5,1],[5,0],[0,0],[0,2],[1,2],[1,3]],
"point2": [[3,2],[3,3],[7,3],[7,0],[12,0],[12,2],[9,2],[9,4],[12,4],[12,5],[9,5],[9,6],[7,6],[7,4],[3,4],[3,6],[2,6],[2,1],[5,1],[5,0],[0,0],[0,2],[1,2],[1,3]]

}
