{
"row":29,
"col":7,
"isloop":0,
"datas":[2,2,2,2,2,1,1,1,1,1,2,2,2,0,0,0,2,2,2,1,1,1,1,1,2,2,2,2,2,
2,2,2,2,2,1,2,2,2,1,2,2,2,0,0,0,2,2,2,1,2,2,2,1,2,2,2,2,2,
2,2,2,2,2,1,2,2,2,1,2,2,2,0,0,0,2,2,2,1,2,2,2,1,2,2,2,2,2,
1,1,1,1,2,1,1,1,2,1,1,1,1,0,0,0,1,1,1,1,2,1,1,1,2,1,1,1,1,
2,2,2,1,2,2,0,1,2,2,2,2,2,0,0,0,2,2,2,2,2,1,0,2,2,1,2,2,2,
2,2,2,1,2,2,2,1,2,2,2,2,2,0,0,0,2,2,2,2,2,1,2,2,2,1,2,2,2,
2,2,2,1,1,1,1,1,2,2,2,2,2,0,0,0,2,2,2,2,2,1,1,1,1,1,2,2,2],

"it1":[448,0,449,0,444,0,0,0,0,0,449,0,401,0,0,0,401,449,0,0,0,0,0,0,444,449,0,448,0,
406,0,451,0,0,0,0,450,0,0,446,414,0,0,0,0,414,0,446,0,450,0,0,0,0,451,0,406,0,
0,0,0,0,412,0,401,0,0,0,0,0,0,0,0,0,0,0,0,0,0,0,401,0,412,0,0,0,0,
0,0,0,0,0,0,0,0,0,0,0,0,0,0,0,0,0,0,0,0,0,0,0,0,0,0,0,0,0,
414,0,446,0,450,0,0,0,412,451,0,406,0,0,0,0,406,0,451,0,412,0,0,450,0,0,446,414,0,
0,0,0,0,0,0,0,0,444,0,0,0,0,0,0,0,0,0,0,0,444,0,0,0,0,0,0,0,0,
401,449,0,0,0,0,0,0,0,449,0,448,0,0,0,0,448,0,449,0,0,0,0,0,0,0,449,0,401],

"it2":[],

"point1": [[0,3],[3,3],[3,6],[7,6],[7,3],[6,3]],
"point2": [[0,3],[3,3],[3,6],[7,6],[7,3],[6,3]],
"point3": [[12,3],[9,3],[9,0],[5,0],[5,3],[6,3]],
"point4": [[12,3],[9,3],[9,0],[5,0],[5,3],[6,3]],
"point5": [[28,3],[25,3],[25,6],[21,6],[21,3],[22,3]],
"point6": [[28,3],[25,3],[25,6],[21,6],[21,3],[22,3]],
"point7": [[16,3],[19,3],[19,0],[23,0],[23,3],[22,3]],
"point8": [[16,3],[19,3],[19,0],[23,0],[23,3],[22,3]]

}
