{
"row":29,
"col":7,
"isloop":0,
"datas":[2,1,1,1,1,1,1,1,1,1,1,1,2,0,0,0,2,1,1,1,1,1,1,1,1,1,1,1,2,
2,1,2,1,1,1,1,1,1,1,1,1,2,0,0,0,2,1,1,1,1,1,1,1,1,1,2,1,2,
2,1,2,1,2,2,2,2,2,2,2,1,2,0,0,0,2,1,2,2,2,2,2,2,2,1,2,1,2,
2,1,2,1,2,2,2,2,2,2,2,1,2,0,0,0,2,1,2,2,2,2,2,2,2,1,2,1,2,
2,1,2,1,1,1,1,1,1,1,2,0,2,0,0,0,2,0,2,1,1,1,1,1,1,1,2,1,2,
2,1,1,1,1,1,1,1,1,1,1,1,2,0,0,0,2,1,1,1,1,1,1,1,1,1,1,1,2,
2,2,2,2,2,2,2,2,2,2,2,2,2,0,0,0,2,2,2,2,2,2,2,2,2,2,2,2,2],

"it1":[0,0,0,0,0,0,0,0,0,0,0,0,401,0,0,0,401,0,0,0,0,0,0,0,0,0,0,0,0,
444,0,412,0,0,0,0,0,0,0,0,0,446,0,0,0,446,0,0,0,0,0,0,0,0,0,412,0,444,
0,0,444,0,801,0,406,0,804,0,443,0,0,0,0,0,0,0,443,804,0,406,0,801,0,0,444,0,0,
446,0,0,0,0,0,0,0,0,0,401,0,445,0,0,0,445,0,401,0,0,0,0,0,0,0,0,0,446,
0,0,412,0,0,0,0,0,0,0,412,0,0,0,0,0,0,0,412,0,0,0,0,0,0,0,412,0,0,
441,0,0,0,0,0,0,0,0,0,0,0,443,0,0,0,443,0,0,0,0,0,0,0,0,0,0,0,441,
0,449,0,442,448,0,443,448,0,442,449,0,401,0,0,0,401,449,0,442,448,0,443,448,0,442,449,0,0],

"it2":[],

"point1": [[11,5],[1,5],[1,0],[11,0],[11,3]],
"point2": [[9,4],[3,4],[3,1],[11,1],[11,3]],
"point3": [[17,5],[27,5],[27,0],[17,0],[17,3]],
"point4": [[19,4],[25,4],[25,1],[17,1],[17,3]]

}
