{
"row":29,
"col":7,
"isloop":0,
"datas":[2,2,2,2,2,1,1,1,1,1,1,1,2,0,0,0,2,1,1,1,1,1,1,1,2,2,2,2,2,
1,1,1,1,2,1,2,2,2,2,2,1,2,0,0,0,2,1,2,2,2,2,2,1,2,1,1,1,1,
1,2,2,1,2,1,2,1,1,1,2,1,2,0,0,0,2,1,2,1,1,1,2,1,2,1,2,2,1,
1,2,1,1,2,1,2,1,1,1,1,1,2,0,0,0,2,1,1,1,1,1,2,1,2,1,1,2,1,
1,2,2,2,2,1,2,2,2,1,2,2,2,0,0,0,2,2,2,1,2,2,2,1,2,2,2,2,1,
1,2,2,2,2,1,2,2,2,1,1,1,1,0,0,0,1,1,1,1,2,2,2,1,2,2,2,2,1,
1,1,1,1,1,1,2,2,2,2,2,2,0,0,0,0,0,2,2,2,2,2,2,1,1,1,1,1,1],

"it1":[447,0,449,0,445,0,0,0,0,0,0,0,441,0,0,0,441,0,0,0,0,0,0,0,445,449,0,447,0,
0,0,0,0,0,0,448,0,0,447,0,0,401,0,0,0,401,0,447,0,0,448,0,0,0,0,0,0,0,
0,445,403,0,443,0,445,0,0,0,443,0,446,0,0,0,446,0,443,0,0,0,445,0,443,0,403,445,0,
0,0,0,0,446,0,0,0,0,0,0,0,0,0,0,0,0,0,0,0,0,0,0,0,446,0,0,0,0,
0,803,0,441,0,0,406,0,441,0,449,0,441,0,0,0,441,449,0,0,441,406,0,0,0,441,803,0,0,
0,0,0,401,412,0,0,0,446,0,0,0,0,0,0,0,0,0,0,0,446,0,0,0,412,401,0,0,0,
0,0,0,0,0,0,449,0,0,0,447,0,0,0,0,0,0,447,0,0,0,449,0,0,0,0,0,0,0],

"it2":[],

"point1": [[2,3],[3,3],[3,1],[0,1],[0,6],[5,6],[5,0],[11,0],[11,3],[7,3],[7,2],[9,2],[9,5],[12,5]],
"point2": [[2,3],[3,3],[3,1],[0,1],[0,6],[5,6],[5,0],[11,0],[11,3],[7,3],[7,2],[9,2],[9,5],[12,5]],
"point3": [[26,3],[25,3],[25,1],[28,1],[28,6],[23,6],[23,0],[17,0],[17,3],[21,3],[21,2],[19,2],[19,5],[16,5]],
"point4": [[26,3],[25,3],[25,1],[28,1],[28,6],[23,6],[23,0],[17,0],[17,3],[21,3],[21,2],[19,2],[19,5],[16,5]]

}
