{
"row":29,
"col":7,
"isloop":0,
"datas":[2,1,1,1,1,1,1,1,1,2,2,2,2,0,0,0,2,2,2,2,1,1,1,1,1,1,1,1,2,
2,0,2,2,2,2,2,2,1,1,2,2,2,0,0,0,2,2,2,1,1,2,2,2,2,2,2,0,2,
2,2,2,2,2,2,2,2,2,1,1,1,2,0,0,0,2,1,1,1,2,2,2,2,2,2,2,2,2,
2,2,1,1,1,1,1,1,1,1,1,1,2,0,0,0,2,1,1,1,1,1,1,1,1,1,1,2,2,
2,1,1,2,2,2,2,2,2,2,2,2,2,0,0,0,2,2,2,2,2,2,2,2,2,2,1,1,2,
2,1,1,1,1,1,1,1,1,1,1,1,2,0,0,0,2,1,1,1,1,1,1,1,1,1,1,1,2,
2,2,2,2,2,2,2,2,2,2,2,2,2,0,0,0,2,2,2,2,2,2,2,2,2,2,2,2,2],

"it1":[445,0,0,0,0,0,0,0,0,448,0,451,0,0,0,0,451,0,448,0,0,0,0,0,0,0,0,0,445,
0,0,801,0,449,0,450,0,0,0,0,0,0,0,0,0,0,0,0,0,0,450,0,449,0,801,0,0,0,
450,0,0,0,443,442,0,0,443,0,0,0,446,0,0,0,446,0,0,0,443,0,0,442,443,0,0,450,0,
0,0,0,0,0,0,0,0,0,0,0,0,0,0,0,0,0,0,0,0,0,0,0,0,0,0,0,0,0,
446,0,0,447,0,449,0,443,447,0,447,0,443,0,0,0,443,447,0,447,0,443,449,0,447,0,0,0,446,
0,0,0,0,0,0,0,0,0,0,0,0,446,0,0,0,446,0,0,0,0,0,0,0,0,0,0,0,0,
401,449,0,441,447,0,447,0,0,448,0,443,0,0,0,0,0,443,448,0,0,447,0,447,0,441,449,0,401],

"it2":[],

"point1": [[11,5],[1,5],[1,4],[2,4],[2,3],[11,3],[11,2],[9,2],[9,1],[8,1],[8,0],[1,0]],
"point2": [[11,5],[1,5],[1,4],[2,4],[2,3],[11,3],[11,2],[9,2],[9,1],[8,1],[8,0],[1,0]],
"point3": [[17,5],[27,5],[27,4],[26,4],[26,3],[17,3],[17,2],[19,2],[19,1],[20,1],[20,0],[27,0]],
"point4": [[17,5],[27,5],[27,4],[26,4],[26,3],[17,3],[17,2],[19,2],[19,1],[20,1],[20,0],[27,0]]

}
