{
"row":29,
"col":7,
"isloop":0,
"datas":[1,1,1,1,1,1,1,1,1,1,1,1,1,0,0,0,1,1,1,1,1,1,1,1,1,1,1,1,1,
1,2,2,2,2,2,2,2,2,2,2,2,1,0,0,0,1,2,2,2,2,2,2,2,2,2,2,2,1,
1,2,2,2,2,2,2,2,2,2,2,2,1,0,0,0,1,2,2,2,2,2,2,2,2,2,2,2,1,
1,2,2,2,2,2,2,2,2,2,2,2,1,0,0,0,1,2,2,2,2,2,2,2,2,2,2,2,1,
1,2,2,2,2,2,2,2,2,2,2,2,1,0,0,0,1,2,2,2,2,2,2,2,2,2,2,2,1,
0,2,2,2,2,2,2,2,2,2,2,2,1,0,0,0,1,2,2,2,2,2,2,2,2,2,2,2,0,
1,1,1,1,1,1,1,1,1,1,1,1,1,0,0,0,1,1,1,1,1,1,1,1,1,1,1,1,1],

"it1":[0,0,0,0,0,0,0,0,0,0,0,0,0,0,0,0,0,0,0,0,0,0,0,0,0,0,0,0,0,
0,401,447,0,442,449,0,443,444,412,0,441,0,0,0,0,0,441,0,412,444,443,449,0,442,447,0,401,0,
0,403,445,412,406,0,449,0,0,446,441,0,0,0,0,0,0,0,441,446,0,449,0,406,0,412,445,403,0,
0,412,0,446,0,0,401,406,0,0,445,412,0,0,0,0,0,412,445,0,406,0,401,0,0,446,0,412,0,
0,805,0,0,444,449,0,0,0,412,0,403,0,0,0,0,0,403,0,412,0,0,449,0,444,0,805,0,0,
0,0,0,412,0,443,449,0,442,447,0,401,0,0,0,0,0,401,447,0,442,449,0,443,0,412,0,0,0,
0,0,0,0,0,0,0,0,0,0,0,0,0,0,0,0,0,0,0,0,0,0,0,0,0,0,0,0,0],

"it2":[],

"point1": [[0,6],[12,6],[12,0],[0,0],[0,4]],
"point2": [[0,6],[12,6],[12,0],[0,0],[0,4]],
"point3": [[28,6],[16,6],[16,0],[28,0],[28,4]],
"point4": [[28,6],[16,6],[16,0],[28,0],[28,4]]

}
