{
"row":29,
"col":7,
"isloop":0,
"datas":[2,2,2,2,2,2,2,2,2,2,2,2,2,0,0,0,2,2,2,2,2,2,2,2,2,2,2,2,2,
2,1,1,1,1,1,2,1,1,1,1,1,2,0,0,0,2,1,1,1,1,1,2,1,1,1,1,1,2,
2,1,2,2,2,1,2,0,2,2,2,1,2,0,0,0,2,1,2,2,2,0,2,1,2,2,2,1,2,
2,1,2,2,2,1,1,1,2,2,2,1,2,0,0,0,2,1,2,2,2,1,1,1,2,2,2,1,2,
2,1,2,2,2,1,2,1,2,2,2,1,2,0,0,0,2,1,2,2,2,1,2,1,2,2,2,1,2,
2,1,1,1,1,1,2,1,1,1,1,1,2,0,0,0,2,1,1,1,1,1,2,1,1,1,1,1,2,
2,2,2,2,2,2,2,2,2,2,2,2,2,0,0,0,2,2,2,2,2,2,2,2,2,2,2,2,2],

"it1":[425,448,0,441,449,0,442,449,0,441,448,0,425,0,0,0,425,448,0,441,449,0,442,449,0,441,448,0,425,
445,0,0,0,0,0,446,0,0,0,0,0,445,0,0,0,445,0,0,0,0,0,446,0,0,0,0,0,445,
0,0,0,403,0,0,0,0,403,0,403,0,0,0,0,0,0,0,403,0,403,0,0,0,0,403,0,0,0,
441,0,403,0,403,0,0,0,0,403,0,0,441,0,0,0,441,0,0,403,0,0,0,0,403,0,403,0,441,
445,0,0,403,0,0,446,0,403,0,403,0,445,0,0,0,445,0,403,0,403,0,446,0,0,403,0,0,445,
0,0,0,0,0,0,0,0,0,0,0,0,0,0,0,0,0,0,0,0,0,0,0,0,0,0,0,0,0,
425,448,0,441,449,0,442,449,0,441,448,0,425,0,0,0,425,448,0,441,449,0,442,449,0,441,448,0,425],

"it2":[2043,0,0,0,0,0,0,0,0,0,0,0,2043,0,0,0,2043,0,0,0,0,0,0,0,0,0,0,0,2043,
0,0,0,0,0,0,0,0,0,0,0,0,0,0,0,0,0,0,0,0,0,0,0,0,0,0,0,0,0,
0,0,0,0,0,0,0,0,0,0,0,0,0,0,0,0,0,0,0,0,0,0,0,0,0,0,0,0,0,
0,0,0,0,0,0,0,0,0,0,0,0,0,0,0,0,0,0,0,0,0,0,0,0,0,0,0,0,0,
0,0,0,0,0,0,0,0,0,0,0,0,0,0,0,0,0,0,0,0,0,0,0,0,0,0,0,0,0,
0,0,0,0,0,0,0,0,0,0,0,0,0,0,0,0,0,0,0,0,0,0,0,0,0,0,0,0,0,
2043,0,0,0,0,0,0,0,0,0,0,0,2043,0,0,0,2043,0,0,0,0,0,0,0,0,0,0,0,2043],

"point1": [[5,4],[5,5],[1,5],[1,1],[5,1],[5,3],[7,3],[7,5],[11,5],[11,1],[7,1]],
"point2": [[5,4],[5,5],[1,5],[1,1],[5,1],[5,3],[7,3],[7,5],[11,5],[11,1],[7,1]],
"point3": [[23,4],[23,5],[27,5],[27,1],[23,1],[23,3],[21,3],[21,5],[17,5],[17,1],[21,1]],
"point4": [[23,4],[23,5],[27,5],[27,1],[23,1],[23,3],[21,3],[21,5],[17,5],[17,1],[21,1]]

}
