{
"row":29,
"col":7,
"isloop":0,
"datas":[1,1,1,1,1,1,1,1,1,1,1,2,2,0,0,0,2,2,1,1,1,1,1,1,1,1,1,1,1,
1,2,2,1,1,2,1,1,1,1,1,2,2,0,0,0,2,2,1,1,1,1,1,2,1,1,2,2,1,
1,2,2,1,0,2,1,2,2,2,2,2,2,0,0,0,2,2,2,2,2,2,1,2,0,1,2,2,1,
1,1,1,1,2,2,1,1,1,1,1,1,1,0,0,0,1,1,1,1,1,1,1,2,2,1,1,1,1,
2,2,2,2,2,2,2,2,2,2,2,2,1,0,0,0,1,2,2,2,2,2,2,2,2,2,2,2,2,
2,1,1,1,1,1,1,1,1,1,1,1,1,0,0,0,1,1,1,1,1,1,1,1,1,1,1,1,2,
2,2,2,2,2,2,2,2,2,2,2,2,2,0,0,0,2,2,2,2,2,2,2,2,2,2,2,2,2],

"it1":[0,0,0,0,0,0,0,0,0,0,0,411,401,0,0,0,401,410,0,0,0,0,0,0,0,0,0,0,0,
0,806,0,0,0,412,0,0,0,0,0,451,0,0,0,0,451,0,0,0,0,0,0,412,0,0,806,0,0,
0,0,0,0,0,446,0,443,448,0,0,0,0,0,0,0,0,0,0,448,0,443,0,446,0,0,0,0,0,
0,0,0,0,443,0,0,0,0,0,0,0,0,0,0,0,0,0,0,0,0,0,0,0,443,0,0,0,0,
443,449,0,447,0,401,403,448,0,447,0,412,0,0,0,0,0,412,447,0,448,0,403,401,447,0,449,0,443,
410,0,0,0,0,0,0,0,0,0,0,0,0,0,0,0,0,0,0,0,0,0,0,0,0,0,0,0,411,
447,0,441,448,0,447,0,442,401,449,0,441,0,0,0,0,0,441,449,0,401,442,447,0,448,0,441,447,0],

"it2":[],

"point1": [[1,5],[12,5],[12,3],[6,3],[6,1],[10,1],[10,0],[0,0],[0,3],[3,3],[3,1],[4,1]],
"point2": [[1,5],[12,5],[12,3],[6,3],[6,1],[10,1],[10,0],[0,0],[0,3],[3,3],[3,1],[4,1]],
"point3": [[27,5],[16,5],[16,3],[22,3],[22,1],[18,1],[18,0],[28,0],[28,3],[25,3],[25,1],[24,1]],
"point4": [[27,5],[16,5],[16,3],[22,3],[22,1],[18,1],[18,0],[28,0],[28,3],[25,3],[25,1],[24,1]]

}
