{
"row":29,
"col":7,
"isloop":0,
"datas":[2,1,1,1,1,1,1,1,1,1,1,1,1,0,0,0,1,1,1,1,1,1,1,1,1,1,1,1,2,
2,1,1,1,1,2,2,1,1,1,1,2,1,0,0,0,1,2,1,1,1,1,2,2,1,1,1,1,2,
1,1,2,2,1,1,1,1,2,2,1,1,1,0,0,0,1,1,1,2,2,1,1,1,1,2,2,1,1,
1,2,2,2,2,2,2,2,2,2,2,2,2,0,0,0,2,2,2,2,2,2,2,2,2,2,2,2,1,
1,1,1,1,1,1,1,1,1,1,1,1,1,0,0,0,1,1,1,1,1,1,1,1,1,1,1,1,1,
2,1,1,1,1,1,1,1,1,1,1,1,1,0,0,0,1,1,1,1,1,1,1,1,1,1,1,1,2,
2,0,2,2,2,2,2,2,2,2,2,2,2,0,0,0,2,2,2,2,2,2,2,2,2,2,2,0,2],

"it1":[410,0,0,0,0,0,0,0,0,0,0,0,0,0,0,0,0,0,0,0,0,0,0,0,0,0,0,0,411,
412,0,0,0,0,449,0,0,0,0,0,412,0,0,0,0,0,412,0,0,0,0,449,0,0,0,0,0,412,
0,0,804,0,0,0,0,0,450,0,0,0,0,0,0,0,0,0,0,450,0,0,0,0,0,804,0,0,0,
0,443,0,0,401,448,0,443,0,0,447,0,401,0,0,0,401,447,0,0,0,443,448,0,401,0,0,443,0,
0,0,0,0,0,0,0,0,0,0,0,0,0,0,0,0,0,0,0,0,0,0,0,0,0,0,0,0,0,
444,0,0,0,0,0,0,0,0,0,0,0,0,0,0,0,0,0,0,0,0,0,0,0,0,0,0,0,444,
0,0,448,0,441,448,0,401,448,0,0,449,0,0,0,0,449,0,0,448,0,401,448,0,441,448,0,0,0],

"it2":[],

"point1": [[1,0],[12,0],[12,2],[10,2],[10,1],[7,1],[7,2],[4,2],[4,1],[1,1],[1,2],[0,2],[0,4],[12,4],[12,5],[1,5]],
"point2": [[1,0],[12,0],[12,2],[10,2],[10,1],[7,1],[7,2],[4,2],[4,1],[1,1],[1,2],[0,2],[0,4],[12,4],[12,5],[1,5]],
"point3": [[27,0],[16,0],[16,2],[18,2],[18,1],[21,1],[21,2],[24,2],[24,1],[27,1],[27,2],[28,2],[28,4],[16,4],[16,5],[27,5]],
"point4": [[27,0],[16,0],[16,2],[18,2],[18,1],[21,1],[21,2],[24,2],[24,1],[27,1],[27,2],[28,2],[28,4],[16,4],[16,5],[27,5]]

}
