{
"row":29,
"col":7,
"isloop":0,
"datas":[2,2,2,2,2,2,2,2,2,2,2,2,2,0,0,0,2,2,2,2,2,2,2,2,2,2,2,2,2,
2,2,2,1,1,1,1,1,1,1,1,1,2,0,0,0,2,1,1,1,1,1,1,1,1,1,2,2,2,
2,2,2,1,2,2,2,2,2,2,2,1,2,0,0,0,2,1,2,2,2,2,2,2,2,1,2,2,2,
2,2,2,1,1,1,1,1,1,1,1,1,1,0,0,0,1,1,1,1,1,1,1,1,1,1,2,2,2,
2,2,2,1,2,2,2,2,2,2,2,1,0,0,0,0,0,1,2,2,2,2,2,2,2,1,2,2,2,
2,2,2,1,1,1,1,1,1,1,1,1,2,0,0,0,2,1,1,1,1,1,1,1,1,1,2,2,2,
2,2,2,2,2,2,2,2,2,2,2,2,2,0,0,0,2,2,2,2,2,2,2,2,2,2,2,2,2],

"it1":[810,0,0,401,0,0,401,0,0,401,0,0,403,0,0,0,403,0,0,401,0,0,401,0,0,401,0,810,0,
0,0,410,0,0,0,0,0,0,0,0,0,0,0,0,0,0,0,0,0,0,0,0,0,0,0,411,0,0,
0,0,0,0,0,0,0,0,0,0,0,0,412,0,0,0,412,0,0,0,0,0,0,0,0,0,0,0,0,
0,0,410,0,0,0,0,0,0,0,0,0,0,0,0,0,0,0,0,0,0,0,0,0,0,0,411,0,0,
0,0,0,0,0,0,0,0,0,0,0,0,0,0,0,0,0,0,0,0,0,0,0,0,0,0,0,0,0,
810,0,410,0,0,0,0,0,0,0,0,0,412,0,0,0,412,0,0,0,0,0,0,0,0,0,411,810,0,
0,0,0,401,0,0,401,0,0,401,0,0,0,0,0,0,0,0,0,401,0,0,401,0,0,401,0,0,0],

"it2":[],

"point1": [[3,3],[3,5],[11,5],[11,3],[12,3]],
"point2": [[3,3],[12,3]],
"point3": [[3,3],[3,1],[11,1],[11,3],[12,3]],
"point4": [[25,3],[25,5],[17,5],[17,3],[16,3]],
"point5": [[25,3],[16,3]],
"point6": [[25,3],[25,1],[17,1],[17,3],[16,3]]

}
