{
"row":29,
"col":7,
"isloop":0,
"datas":[2,2,2,2,2,2,2,2,2,2,1,1,1,0,0,0,1,1,1,2,2,2,2,2,2,2,2,2,2,
2,1,1,1,1,1,1,1,1,1,1,2,0,0,0,0,0,2,1,1,1,1,1,1,1,1,1,1,2,
2,2,2,2,2,2,1,2,2,2,2,2,2,0,0,0,2,2,2,2,2,2,1,2,2,2,2,2,2,
2,2,2,2,2,2,1,2,2,2,2,2,2,0,0,0,2,2,2,2,2,2,1,2,2,2,2,2,2,
2,2,2,2,2,2,1,2,2,2,2,2,2,0,0,0,2,2,2,2,2,2,1,2,2,2,2,2,2,
2,2,2,2,2,2,1,1,1,1,1,2,2,0,0,0,2,2,1,1,1,1,1,2,2,2,2,2,2,
2,2,2,2,2,2,2,2,2,2,1,1,1,0,0,0,1,1,1,2,2,2,2,2,2,2,2,2,2],

"it1":[449,0,448,0,412,442,441,449,0,0,0,0,0,0,0,0,0,0,0,0,449,0,441,442,412,448,0,449,0,
410,0,0,0,0,0,0,0,0,0,0,443,0,0,0,0,0,443,0,0,0,0,0,0,0,0,0,0,411,
441,449,0,401,448,0,0,450,0,451,0,443,0,0,0,0,0,443,451,0,450,0,0,448,0,401,449,0,441,
406,0,450,0,445,441,0,0,0,0,0,450,0,0,0,0,450,0,0,0,0,0,0,441,445,450,0,406,0,
0,0,0,0,0,446,0,412,448,0,401,0,0,0,0,0,0,0,401,448,0,412,0,446,0,0,0,0,0,
413,0,406,0,442,0,0,0,0,0,0,447,0,0,0,0,447,0,0,0,0,0,0,0,442,406,0,413,0,
0,0,0,0,448,0,447,0,448,0,0,0,0,0,0,0,0,0,0,448,0,447,0,448,0,0,0,0,0],

"it2":[],

"point1": [[1,1],[10,1],[10,0],[12,0]],
"point2": [[1,1],[10,1],[10,0],[12,0]],
"point3": [[12,6],[10,6],[10,5],[6,5],[6,1],[10,1],[10,0],[12,0]],
"point4": [[12,6],[10,6],[10,5],[6,5],[6,1],[10,1],[10,0],[12,0]],
"point5": [[27,1],[18,1],[18,0],[16,0]],
"point6": [[27,1],[18,1],[18,0],[16,0]],
"point7": [[16,6],[18,6],[18,5],[22,5],[22,1],[18,1],[18,0],[16,0]],
"point8": [[16,6],[18,6],[18,5],[22,5],[22,1],[18,1],[18,0],[16,0]]

}
