{
"row":29,
"col":7,
"isloop":0,
"datas":[2,2,2,2,2,2,2,2,2,2,2,2,2,0,0,0,2,2,2,2,2,2,2,2,2,2,2,2,2,
2,1,1,1,1,1,1,1,1,1,1,1,2,0,0,0,2,1,1,1,1,1,1,1,1,1,1,1,2,
2,0,2,2,2,2,2,2,2,2,2,1,2,0,0,0,2,1,2,2,2,2,2,2,2,2,2,0,2,
2,2,2,2,2,2,2,2,2,2,2,1,2,0,0,0,2,1,2,2,2,2,2,2,2,2,2,2,2,
2,2,2,2,2,2,2,2,2,2,2,1,2,0,0,0,2,1,2,2,2,2,2,2,2,2,2,2,2,
2,2,2,2,2,1,1,1,1,1,1,1,2,0,0,0,2,1,1,1,1,1,1,1,2,2,2,2,2,
2,2,2,2,2,2,2,2,2,2,2,2,2,0,0,0,2,2,2,2,2,2,2,2,2,2,2,2,2],

"it1":[0,0,0,0,448,0,0,0,0,0,0,0,0,0,0,0,0,0,0,0,0,0,0,448,0,0,0,0,0,
0,0,0,0,0,0,0,0,0,0,0,0,0,0,0,0,0,0,0,0,0,0,0,0,0,0,0,0,0,
0,0,0,0,0,801,0,0,0,449,0,0,0,0,0,0,0,0,449,0,0,0,801,0,0,0,0,0,0,
0,0,450,0,0,0,0,0,0,0,0,0,0,0,0,0,0,0,0,0,0,0,0,0,0,450,0,0,0,
0,445,0,0,0,0,0,0,448,0,0,0,0,0,0,0,0,0,0,448,0,0,0,0,0,0,0,445,0,
0,0,0,0,0,0,0,0,0,0,0,0,0,0,0,0,0,0,0,0,0,0,0,0,0,0,0,0,0,
0,0,0,0,0,0,0,0,0,448,0,0,0,0,0,0,0,0,448,0,0,0,0,0,0,0,0,0,0],

"it2":[],

"point1": [[5,5],[11,5],[11,1],[1,1]],
"point2": [[5,5],[11,5],[11,1],[1,1]],
"point3": [[23,5],[17,5],[17,1],[27,1]],
"point4": [[23,5],[17,5],[17,1],[27,1]]

}
