{
"row":29,
"col":7,
"isloop":0,
"datas":[2,2,2,2,2,2,2,2,2,2,2,2,2,0,0,0,2,2,2,2,2,2,2,2,2,2,2,2,2,
2,2,2,1,1,1,1,1,1,1,2,2,2,0,0,0,2,2,2,1,1,1,1,1,1,1,2,2,2,
2,2,2,1,0,2,2,2,2,1,2,2,2,0,0,0,2,2,2,1,2,2,2,2,0,1,2,2,2,
2,2,2,1,2,2,2,2,2,1,2,2,2,0,0,0,2,2,2,1,2,2,2,2,2,1,2,2,2,
2,2,2,1,2,2,2,2,2,1,2,2,2,0,0,0,2,2,2,1,2,2,2,2,2,1,2,2,2,
2,2,2,1,1,1,1,1,1,1,1,1,2,0,0,0,2,1,1,1,1,1,1,1,1,1,2,2,2,
2,2,2,2,2,2,2,2,2,2,2,1,1,0,0,0,1,1,2,2,2,2,2,2,2,2,2,2,2],

"it1":[0,0,403,0,403,0,403,0,403,0,403,0,0,0,0,0,0,0,403,0,403,0,403,0,403,0,403,0,0,
401,0,0,0,0,0,0,0,0,0,0,0,401,0,0,0,401,0,0,0,0,0,0,0,0,0,0,0,401,
0,0,403,0,0,412,412,412,0,0,403,0,0,0,0,0,0,0,403,0,0,412,412,412,0,0,403,0,0,
401,0,0,0,0,412,0,412,0,0,0,0,401,0,0,0,401,0,0,0,0,412,0,412,0,0,0,0,401,
0,0,403,0,0,412,412,412,0,0,403,0,0,0,0,0,0,0,403,0,0,412,412,412,0,0,403,0,0,
401,0,0,0,0,0,0,0,0,0,0,0,401,0,0,0,401,0,0,0,0,0,0,0,0,0,0,0,401,
0,0,403,0,403,0,403,0,403,0,403,0,0,0,0,0,0,0,403,0,403,0,403,0,403,0,403,0,0],

"it2":[],

"point1": [[3,1],[3,5],[9,5],[9,1],[4,1]],
"point2": [[12,6],[11,6],[11,5],[9,5],[9,1],[4,1]],
"point3": [[25,1],[25,5],[19,5],[19,1],[24,1]],
"point4": [[16,6],[17,6],[17,5],[19,5],[19,1],[24,1]]

}
