{
"row":29,
"col":7,
"isloop":0,
"datas":[2,2,2,2,2,2,2,2,2,2,2,2,2,0,0,0,2,2,2,2,2,2,2,2,2,2,2,2,2,
2,1,1,1,1,1,2,1,1,1,1,1,2,0,0,0,2,1,1,1,1,1,2,1,1,1,1,1,2,
2,1,2,2,2,1,2,1,2,2,2,1,2,0,0,0,2,1,2,2,2,1,2,1,2,2,2,1,2,
2,1,1,1,2,1,2,1,2,1,1,1,2,0,0,0,2,1,1,1,2,1,2,1,2,1,1,1,2,
2,2,2,1,2,1,2,1,2,1,2,2,2,0,0,0,2,2,2,1,2,1,2,1,2,1,2,2,2,
2,1,1,1,2,1,1,1,2,1,1,1,2,0,0,0,2,1,1,1,2,1,1,1,2,1,1,1,2,
2,2,2,2,2,2,2,2,2,2,2,0,2,0,0,0,2,0,2,2,2,2,2,2,2,2,2,2,2],

"it1":[404,0,404,0,404,0,404,0,404,0,404,0,404,0,0,0,404,0,404,0,404,0,404,0,404,0,404,0,404,
410,0,0,0,0,0,410,0,0,0,0,0,0,0,0,0,0,0,0,0,0,0,411,0,0,0,0,0,411,
404,0,404,0,404,0,404,0,404,0,404,0,404,0,0,0,404,0,404,0,404,0,404,0,404,0,404,0,404,
0,0,0,0,411,0,0,0,0,0,0,0,411,0,0,0,410,0,0,0,0,0,0,0,410,0,0,0,0,
404,0,404,0,404,0,404,0,404,0,404,0,404,0,0,0,404,0,404,0,404,0,404,0,404,0,404,0,404,
410,0,0,0,410,0,0,0,410,0,0,0,0,0,0,0,0,0,0,0,411,0,0,0,411,0,0,0,411,
404,0,404,0,404,0,404,0,404,0,404,0,404,0,0,0,404,0,404,0,404,0,404,0,404,0,404,0,404],

"it2":[1000,0,1000,0,1000,0,1000,0,1000,0,1000,0,1000,0,0,0,1000,0,1000,0,1000,0,1000,0,1000,0,1000,0,1000,
0,0,0,0,0,0,0,0,0,0,0,0,0,0,0,0,0,0,0,0,0,0,0,0,0,0,0,0,0,
1000,0,1000,0,1000,0,1000,0,1000,0,1000,0,1000,0,0,0,1000,0,1000,0,1000,0,1000,0,1000,0,1000,0,1000,
0,0,0,0,0,0,0,0,0,0,0,0,0,0,0,0,0,0,0,0,0,0,0,0,0,0,0,0,0,
1000,0,1000,0,1000,0,1000,0,1000,0,1000,0,1000,0,0,0,1000,0,1000,0,1000,0,1000,0,1000,0,1000,0,1000,
0,0,0,0,0,0,0,0,0,0,0,0,0,0,0,0,0,0,0,0,0,0,0,0,0,0,0,0,0,
1000,0,1000,0,1000,0,1000,0,1000,0,1000,0,1000,0,0,0,1000,0,1000,0,1000,0,1000,0,1000,0,1000,0,1000],

"point1": [[1,5],[3,5],[3,3],[1,3],[1,1],[5,1],[5,5],[7,5],[7,1],[11,1],[11,3],[9,3],[9,5],[11,5]],
"point2": [[1,5],[3,5],[3,3],[1,3],[1,1],[5,1],[5,5],[7,5],[7,1],[11,1],[11,3],[9,3],[9,5],[11,5]],
"point3": [[27,5],[25,5],[25,3],[27,3],[27,1],[23,1],[23,5],[21,5],[21,1],[17,1],[17,3],[19,3],[19,5],[17,5]],
"point4": [[27,5],[25,5],[25,3],[27,3],[27,1],[23,1],[23,5],[21,5],[21,1],[17,1],[17,3],[19,3],[19,5],[17,5]]

}
