{
"row":29,
"col":7,
"isloop":0,
"datas":[2,2,2,2,2,2,2,2,2,2,2,2,2,0,0,0,2,2,2,2,2,2,2,2,2,2,2,2,2,
2,2,2,2,2,2,1,1,1,1,1,1,1,0,0,0,1,1,1,1,1,1,1,2,2,2,2,2,2,
2,2,2,2,2,2,1,2,2,2,2,2,2,0,0,0,2,2,2,2,2,2,1,2,2,2,2,2,2,
2,2,1,1,1,1,1,1,2,2,2,2,2,0,0,0,2,2,2,2,2,1,1,1,1,1,1,2,2,
2,2,1,2,2,2,1,0,2,2,2,2,2,0,0,0,2,2,2,2,2,0,1,2,2,2,1,2,2,
1,1,1,2,2,2,1,1,1,1,1,1,1,0,0,0,1,1,1,1,1,1,1,2,2,2,1,1,1,
2,2,2,2,2,2,2,2,2,2,2,2,2,0,0,0,2,2,2,2,2,2,2,2,2,2,2,2,2],

"it1":[0,0,0,0,406,0,0,0,0,0,0,0,0,0,0,0,0,0,0,0,0,0,0,406,0,0,0,0,0,
0,0,404,0,0,0,0,0,0,0,0,0,0,0,0,0,0,0,0,0,0,0,0,0,0,0,404,0,0,
0,0,0,0,412,0,0,412,812,0,0,0,0,0,0,0,0,0,0,812,0,412,0,0,412,0,0,0,0,
804,0,0,0,0,0,0,0,0,0,0,0,0,0,0,0,0,0,0,0,0,0,0,0,0,0,0,804,0,
0,0,0,401,0,0,0,0,0,0,412,0,0,0,0,0,0,0,412,0,0,0,0,0,0,401,0,0,0,
0,0,0,0,0,0,0,0,0,0,0,0,0,0,0,0,0,0,0,0,0,0,0,0,0,0,0,0,0,
0,404,0,0,0,0,0,0,0,404,0,0,0,0,0,0,0,0,0,404,0,0,0,0,0,0,0,404,0],

"it2":[0,0,0,0,0,0,0,0,0,0,0,0,0,0,0,0,0,0,0,0,0,0,0,0,0,0,0,0,0,
0,0,904,0,0,0,0,0,0,0,0,0,0,0,0,0,0,0,0,0,0,0,0,0,0,0,904,0,0,
0,0,0,0,0,0,0,0,0,0,0,0,0,0,0,0,0,0,0,0,0,0,0,0,0,0,0,0,0,
0,0,0,0,0,0,0,0,0,0,0,0,0,0,0,0,0,0,0,0,0,0,0,0,0,0,0,0,0,
0,0,0,0,0,0,0,0,0,0,0,0,0,0,0,0,0,0,0,0,0,0,0,0,0,0,0,0,0,
0,0,0,0,0,0,0,0,0,0,0,0,0,0,0,0,0,0,0,0,0,0,0,0,0,0,0,0,0,
0,904,0,0,0,0,0,0,0,904,0,0,0,0,0,0,0,0,0,904,0,0,0,0,0,0,0,904,0],

"point1": [[0,5],[2,5],[2,3],[7,3]],
"point2": [[12,5],[6,5],[6,3],[7,3]],
"point3": [[12,5],[6,5],[6,3],[7,3]],
"point4": [[12,1],[6,1],[6,3],[7,3]],
"point5": [[12,1],[6,1],[6,3],[7,3]],
"point6": [[28,5],[26,5],[26,3],[21,3]],
"point7": [[16,5],[22,5],[22,3],[21,3]],
"point8": [[16,5],[22,5],[22,3],[21,3]],
"point9": [[16,1],[22,1],[22,3],[21,3]],
"point10": [[16,1],[22,1],[22,3],[21,3]]

}
