{
"row":29,
"col":7,
"isloop":0,
"datas":[1,1,1,1,1,1,1,1,1,1,1,1,2,0,0,0,2,1,1,1,1,1,1,1,1,1,1,1,1,
2,1,2,2,2,2,2,2,2,2,1,2,2,0,0,0,2,2,1,2,2,2,2,2,2,2,2,1,2,
2,1,2,1,1,1,1,1,1,2,1,2,2,0,0,0,2,2,1,2,1,1,1,1,1,1,2,1,2,
2,1,2,0,2,2,2,2,1,2,1,2,2,0,0,0,2,2,1,2,1,2,2,2,2,0,2,1,2,
2,1,1,1,1,1,1,1,1,2,1,2,2,0,0,0,2,2,1,2,1,1,1,1,1,1,1,1,2,
2,2,2,2,2,2,2,2,1,2,1,2,2,0,0,0,2,2,1,2,1,2,2,2,2,2,2,2,2,
2,1,1,1,1,1,1,1,1,1,1,1,1,0,0,0,1,1,1,1,1,1,1,1,1,1,1,1,2],

"it1":[0,0,0,0,0,0,0,0,0,0,0,0,411,0,0,0,410,0,0,0,0,0,0,0,0,0,0,0,0,
0,0,412,0,0,0,0,0,412,0,0,414,0,0,0,0,414,0,0,0,412,0,0,0,0,0,412,0,0,
0,0,0,0,0,0,0,0,0,411,0,0,0,0,0,0,0,0,0,410,0,0,0,0,0,0,0,0,0,
0,0,0,0,0,0,0,0,0,0,0,0,0,0,0,0,0,0,0,0,0,0,0,0,0,0,0,0,0,
410,0,0,0,0,0,0,0,0,0,0,414,0,0,0,0,414,0,0,0,0,0,0,0,0,0,0,0,411,
0,0,412,0,0,0,0,412,0,0,0,0,0,0,0,0,0,0,0,0,0,412,0,0,0,0,412,0,0,
410,0,0,0,0,0,0,0,0,0,0,0,0,0,0,0,0,0,0,0,0,0,0,0,0,0,0,0,411],

"it2":[],

"point1": [[1,6],[10,6],[10,0],[1,0],[1,4],[8,4],[8,2],[3,2]],
"point2": [[12,6],[10,6],[10,0],[1,0],[1,4],[8,4],[8,2],[3,2]],
"point3": [[11,0],[1,0],[1,4],[8,4],[8,2],[3,2]],
"point4": [[0,0],[1,0],[1,4],[8,4],[8,2],[3,2]],
"point5": [[8,5],[8,2],[3,2]],
"point6": [[27,6],[18,6],[18,0],[27,0],[27,4],[20,4],[20,2],[25,2]],
"point7": [[16,6],[18,6],[18,0],[27,0],[27,4],[20,4],[20,2],[25,2]],
"point8": [[17,0],[27,0],[27,4],[20,4],[20,2],[25,2]],
"point9": [[28,0],[27,0],[27,4],[20,4],[20,2],[25,2]],
"point10": [[20,5],[20,2],[25,2]]

}
