{
"row":29,
"col":7,
"isloop":0,
"datas":[2,2,2,2,2,2,2,2,2,2,2,1,2,0,0,0,2,1,2,2,2,2,2,2,2,2,2,2,2,
2,2,1,1,1,1,1,1,1,1,1,1,2,0,0,0,2,1,1,1,1,1,1,1,1,1,1,2,2,
2,2,1,2,2,2,2,2,2,2,2,1,2,0,0,0,2,1,2,2,2,2,2,2,2,2,1,2,2,
2,2,1,2,2,2,1,2,2,2,2,1,2,0,0,0,2,1,2,2,2,2,1,2,2,2,1,2,2,
2,2,1,2,2,2,1,2,2,2,2,1,2,0,0,0,2,1,2,2,2,2,1,2,2,2,1,2,2,
2,2,1,2,2,2,1,1,1,1,1,1,2,0,0,0,2,1,1,1,1,1,1,2,2,2,1,2,2,
2,2,0,2,2,2,2,2,2,2,2,2,2,0,0,0,2,2,2,2,2,2,2,2,2,2,0,2,2],

"it1":[406,0,0,0,0,0,0,0,0,0,0,0,0,0,0,0,0,0,0,0,0,0,0,0,0,0,0,406,0,
0,0,0,0,0,0,0,0,0,0,0,0,411,0,0,0,410,0,0,0,0,0,0,0,0,0,0,0,0,
0,0,0,412,0,0,0,0,0,0,0,0,412,0,0,0,412,0,0,0,0,0,0,0,0,412,0,0,0,
0,0,0,0,425,0,0,807,0,0,0,0,0,0,0,0,0,0,0,0,807,0,0,0,425,0,0,0,0,
401,0,0,0,0,0,0,0,0,0,412,0,0,0,0,0,0,0,412,0,0,0,0,0,0,0,0,0,401,
0,0,0,0,0,410,0,0,0,0,0,0,0,0,0,0,0,0,0,0,0,0,0,411,0,0,0,0,0,
0,0,0,0,0,0,0,0,0,0,0,0,425,0,0,0,425,0,0,0,0,0,0,0,0,0,0,0,0],

"it2":[0,0,0,0,0,0,0,0,0,0,0,0,0,0,0,0,0,0,0,0,0,0,0,0,0,0,0,0,0,
0,0,0,0,0,0,0,0,0,0,0,0,0,0,0,0,0,0,0,0,0,0,0,0,0,0,0,0,0,
0,0,0,0,0,0,0,0,0,0,0,0,0,0,0,0,0,0,0,0,0,0,0,0,904,0,0,0,0,
0,0,0,0,904,0,0,0,0,0,0,0,0,0,0,0,0,0,0,0,0,0,0,0,0,0,0,0,0,
0,0,0,0,0,0,0,0,0,0,0,0,0,0,0,0,0,0,0,0,0,0,0,0,0,0,0,0,0,
0,0,0,0,0,0,0,0,0,0,0,0,0,0,0,0,0,0,0,0,0,0,0,0,0,0,0,0,0,
0,0,0,0,0,0,0,0,0,0,0,0,904,0,0,0,904,0,0,0,0,0,0,0,0,0,0,0,0],

"point1": [[6,3],[6,5],[11,5],[11,1],[2,1],[2,5]],
"point2": [[6,3],[6,5],[11,5],[11,1],[2,1],[2,5]],
"point3": [[11,0],[11,1],[2,1],[2,5]],
"point4": [[11,0],[11,1],[2,1],[2,5]],
"point5": [[22,3],[22,5],[17,5],[17,1],[26,1],[26,5]],
"point6": [[22,3],[22,5],[17,5],[17,1],[26,1],[26,5]],
"point7": [[17,0],[17,1],[26,1],[26,5]],
"point8": [[17,0],[17,1],[26,1],[26,5]]

}
