{
"row":29,
"col":7,
"isloop":0,
"datas":[1,1,1,1,1,1,1,1,1,1,1,2,2,0,0,0,2,2,1,1,1,1,1,1,1,1,1,1,1,
2,2,1,1,1,1,1,1,1,2,1,2,2,0,0,0,2,2,1,2,1,1,1,1,1,1,1,2,2,
2,2,1,2,2,2,2,2,1,2,1,2,2,0,0,0,2,2,1,2,1,2,2,2,2,2,1,2,2,
2,2,1,2,1,1,1,1,1,2,1,2,2,0,0,0,2,2,1,2,1,1,1,1,1,2,1,2,2,
2,2,1,2,1,2,0,2,2,2,1,2,2,0,0,0,2,2,1,2,2,2,0,2,1,2,1,2,2,
2,2,1,2,1,1,1,1,1,1,1,2,2,0,0,0,2,2,1,1,1,1,1,1,1,2,1,2,2,
2,2,1,1,1,1,1,1,1,1,1,1,1,0,0,0,1,1,1,1,1,1,1,1,1,1,1,2,2],

"it1":[0,0,0,0,0,0,0,0,0,0,0,401,0,0,0,0,0,401,0,0,0,0,0,0,0,0,0,0,0,
0,401,0,0,0,0,0,0,0,0,0,0,0,0,0,0,0,0,0,0,0,0,0,0,0,0,0,401,0,
0,7013,0,412,0,404,0,412,0,404,0,0,0,0,0,0,0,0,0,404,0,412,0,404,0,412,0,7013,0,
0,0,0,0,0,0,0,0,0,0,0,0,0,0,0,0,0,0,0,0,0,0,0,0,0,0,0,0,0,
0,0,0,404,0,412,0,404,0,412,0,7013,0,0,0,0,0,7013,0,412,0,404,0,412,0,404,0,0,0,
0,0,0,0,0,0,0,0,0,0,0,401,0,0,0,0,0,401,0,0,0,0,0,0,0,0,0,0,0,
0,401,0,0,0,0,0,0,0,0,0,0,0,0,0,0,0,0,0,0,0,0,0,0,0,0,0,401,0],

"it2":[0,0,0,0,0,0,0,0,0,0,0,0,0,0,0,0,0,0,0,0,0,0,0,0,0,0,0,0,0,
0,0,0,0,0,0,0,0,0,0,0,0,0,0,0,0,0,0,0,0,0,0,0,0,0,0,0,0,0,
0,0,0,0,0,1070,0,0,0,1070,0,0,0,0,0,0,0,0,0,1070,0,0,0,1070,0,0,0,0,0,
0,0,0,0,0,0,0,0,0,0,0,0,0,0,0,0,0,0,0,0,0,0,0,0,0,0,0,0,0,
0,0,0,1070,0,0,0,1070,0,0,0,0,0,0,0,0,0,0,0,0,0,1070,0,0,0,1070,0,0,0,
0,0,0,0,0,0,0,0,0,0,0,0,0,0,0,0,0,0,0,0,0,0,0,0,0,0,0,0,0,
0,0,0,0,0,0,0,0,0,0,0,0,0,0,0,0,0,0,0,0,0,0,0,0,0,0,0,0,0],

"point1": [[0,0],[10,0],[10,5],[4,5],[4,3],[6,3]],
"point2": [[0,0],[10,0],[10,5],[4,5],[4,3],[6,3]],
"point3": [[12,6],[2,6],[2,1],[8,1],[8,3],[6,3]],
"point4": [[12,6],[2,6],[2,1],[8,1],[8,3],[6,3]],
"point5": [[28,0],[18,0],[18,5],[24,5],[24,3],[22,3]],
"point6": [[28,0],[18,0],[18,5],[24,5],[24,3],[22,3]],
"point7": [[16,6],[26,6],[26,1],[20,1],[20,3],[22,3]],
"point8": [[16,6],[26,6],[26,1],[20,1],[20,3],[22,3]]

}
