{
"row":13,
"col":7,
"isloop":0,
"datas":[2,2,2,2,2,2,2,2,2,2,2,2,2,
2,2,2,2,1,1,1,1,1,1,1,1,1,
2,2,2,2,1,2,2,2,2,2,2,2,1,
2,1,1,1,1,1,1,1,1,1,2,2,1,
2,0,2,2,1,2,2,2,2,1,2,2,1,
2,1,1,1,1,2,2,2,2,1,1,1,1,
2,2,2,2,2,2,2,2,2,2,2,2,2],

"it1":[401,508,0,1011,507,0,501,508,0,500,508,0,4011,
503,504,510,0,0,0,0,0,0,0,0,0,0,
505,0,0,0,0,509,0,500,401,500,506,404,0,
0,0,0,0,0,0,0,0,0,0,0,505,0,
504,0,508,0,0,404,500,510,0,0,500,0,0,
0,0,0,0,0,510,0,0,0,0,0,0,0,
500,508,0,401,501,0,0,507,0,500,507,0,401],

"it2":[0,0,0,0,0,0,0,0,0,0,0,0,0,
0,0,0,0,0,0,0,0,0,0,0,0,0,
0,0,0,0,0,0,0,0,0,0,0,1100,0,
0,0,0,0,0,0,0,0,0,0,0,0,0,
0,0,0,0,0,1310,0,0,0,0,0,0,0,
0,0,0,0,0,0,0,0,0,0,0,0,0,
0,0,0,0,0,0,0,0,0,0,0,0,0],

"point1": [[1,5],[4,5],[4,1],[12,1],[12,5],[9,5],[9,3],[1,3]],
"point2": [[1,5],[4,5],[4,1],[12,1],[12,5],[9,5],[9,3],[1,3]]

}
