{
"row":13,
"col":7,
"isloop":0,
"datas":[1,1,1,2,2,1,1,1,2,2,2,2,2,
1,2,1,2,2,0,2,1,1,1,1,2,2,
1,2,1,2,2,2,2,1,1,2,1,2,2,
1,2,1,2,2,2,2,2,2,2,1,2,2,
1,2,1,1,1,1,1,1,1,1,1,2,2,
1,2,2,2,2,2,2,2,2,2,2,2,2,
2,2,2,2,2,2,2,2,2,2,2,2,2],

"it1":[0,0,0,507,0,0,0,0,0,507,0,505,401,
0,404,0,511,0,0,506,0,0,0,0,0,502,
0,506,0,0,0,504,0,0,0,404,0,511,0,
0,0,0,508,0,0,508,0,507,0,0,0,0,
0,503,0,0,0,0,0,0,0,0,0,511,0,
0,406,0,404,509,0,502,506,404,505,503,0,0,
425,0,0,508,0,503,401,0,503,0,508,0,500],

"it2":[0,0,0,0,0,0,0,0,0,0,0,0,0,
0,1330,0,0,0,0,0,0,0,0,0,0,0,
0,0,0,0,0,0,0,0,0,1330,0,0,0,
0,0,0,0,0,0,0,0,0,0,0,0,0,
0,0,0,0,0,0,0,0,0,0,0,0,0,
0,0,0,1100,0,0,0,0,1100,0,0,0,0,
6011,0,0,0,0,0,0,0,0,0,0,0,0],

"point1": [[0,5],[0,0],[2,0],[2,4],[10,4],[10,1],[8,1],[8,2],[7,2],[7,0],[5,0]],
"point2": [[0,5],[0,0],[2,0],[2,4],[10,4],[10,1],[8,1],[8,2],[7,2],[7,0],[5,0]]

}
