{
"row":13,
"col":7,
"isloop":1,
"datas":[2,1,1,1,1,1,1,2,2,2,2,2,2,
2,1,2,2,1,1,1,1,1,1,1,1,2,
2,1,2,2,1,2,1,2,2,2,2,1,2,
2,1,1,1,1,1,1,2,2,2,2,1,2,
2,2,2,2,1,2,2,2,2,2,2,1,2,
2,2,2,2,1,1,1,1,1,1,1,1,2,
2,2,2,2,2,2,2,2,2,2,2,2,2],

"it1":[503,0,0,0,0,0,0,401,508,0,500,508,0,
505,0,401,505,0,0,0,0,0,0,0,0,0,
0,0,503,0,0,404,0,508,0,511,0,0,506,
503,0,0,0,0,0,0,510,0,0,0,0,0,
507,0,506,500,0,502,404,0,0,503,401,0,500,
510,0,0,505,0,0,0,0,0,0,0,0,505,
0,0,0,0,507,0,502,509,0,508,0,500,0],

"it2":[0,0,0,0,0,0,0,0,0,0,0,0,0,
0,0,0,0,0,0,0,0,0,0,0,0,0,
0,0,0,0,0,1320,0,0,0,0,0,0,0,
0,0,0,0,0,0,0,0,0,0,0,0,0,
0,0,0,0,0,0,1370,0,0,0,0,0,0,
0,0,0,0,0,0,0,0,0,0,0,0,0,
0,0,0,0,0,0,0,0,0,0,0,0,0],

"point1": [[4,5],[4,1],[11,1],[11,5],[4,5]],
"point2": [[1,0],[1,3],[6,3],[6,0],[1,0]]

}
