{
"row":13,
"col":7,
"isloop":0,
"datas":[2,2,2,2,2,2,2,2,2,1,1,1,1,
2,2,2,2,2,2,2,2,2,1,1,0,1,
2,2,1,1,1,1,1,1,2,1,1,2,1,
2,2,1,2,2,2,2,1,2,1,1,1,1,
2,2,1,2,2,2,2,1,2,1,1,2,2,
2,2,1,2,2,2,2,1,1,1,1,2,2,
2,2,1,2,2,2,2,2,2,2,2,2,2],

"it1":[507,0,508,0,500,502,507,0,504,0,0,0,0,
510,0,0,507,0,509,0,500,0,0,0,0,0,
0,0,0,0,0,0,0,0,501,0,0,401,0,
500,506,0,511,0,404,501,0,506,0,0,0,0,
505,0,0,0,0,500,505,0,0,0,0,506,502,
0,401,0,501,508,0,0,0,0,0,0,0,504,
508,0,0,507,0,507,0,502,509,0,502,401,0],

"it2":[0,0,0,0,0,0,0,0,0,0,0,0,0,
0,0,0,0,0,0,0,0,0,0,0,0,0,
0,0,0,0,0,0,0,0,0,0,0,0,0,
0,0,0,0,0,1100,0,0,0,0,0,0,0,
0,0,0,0,0,0,0,0,0,0,0,0,0,
0,0,0,0,0,0,0,0,0,0,0,0,0,
0,0,0,0,0,0,0,0,0,0,0,0,0],

"point1": [[2,6],[2,2],[7,2],[7,5],[10,5],[10,4],[9,4],[9,0],[10,0],[10,3],[12,3],[12,0],[11,0]],
"point2": [[2,6],[2,2],[7,2],[7,5],[10,5],[10,4],[9,4],[9,0],[10,0],[10,3],[12,3],[12,0],[11,0]]

}
