{
"row":13,
"col":7,
"isloop":0,
"datas":[1,1,2,2,2,2,2,2,2,2,2,1,2,
0,1,2,2,2,2,2,2,2,2,2,1,2,
2,1,2,2,2,1,1,1,2,2,2,1,2,
2,1,2,2,1,1,2,1,1,2,2,1,2,
2,1,2,1,1,2,2,2,1,1,2,1,2,
2,1,1,1,2,2,2,2,2,1,1,1,2,
2,1,1,2,2,2,2,2,2,2,1,1,2],

"it1":[0,0,423,426,0,424,432,424,426,0,423,0,0,
0,0,433,0,422,0,0,426,0,433,0,0,421,
430,0,0,0,0,0,0,0,0,0,0,0,431,
0,0,429,0,0,0,430,0,0,426,0,0,0,
431,0,423,0,0,0,0,0,0,0,424,0,431,
0,0,0,0,433,0,432,433,0,0,0,0,0,
0,0,0,424,0,0,0,0,0,428,0,0,0],

"it2":[0,0,0,0,0,0,0,0,0,0,0,0,0,
0,0,0,0,0,0,0,0,0,0,0,0,0,
0,0,0,0,0,0,0,0,0,0,0,0,0,
0,0,0,0,0,0,0,0,0,0,0,0,0,
0,0,5013,0,0,0,0,0,0,0,7013,0,0,
0,0,0,0,0,0,0,0,0,0,0,0,0,
0,0,0,0,0,0,0,0,0,0,0,0,0],

"point1": [[11,0],[11,6],[10,6],[10,5],[9,5],[9,4],[8,4],[8,3],[7,3],[7,2],[5,2],[5,3],[4,3],[4,4],[3,4],[3,5],[2,5],[2,6],[1,6],[1,0],[0,0]],
"point2": [[11,0],[11,6],[10,6],[10,5],[9,5],[9,4],[8,4],[8,3],[7,3],[7,2],[5,2],[5,3],[4,3],[4,4],[3,4],[3,5],[2,5],[2,6],[1,6],[1,0],[0,0]]

}
