{
"row":13,
"col":7,
"isloop":0,
"datas":[2,2,2,1,1,1,1,1,1,1,2,2,2,
2,2,2,1,2,2,2,2,2,0,2,2,2,
2,2,2,1,1,1,1,4,2,2,2,2,2,
2,2,2,2,2,2,1,1,1,2,2,2,2,
2,2,2,2,2,2,2,4,1,1,2,2,2,
2,2,2,1,1,1,1,1,1,1,2,2,2,
2,2,2,2,2,2,2,2,2,2,2,2,2],

"it1":[541,401,425,0,0,0,0,0,0,0,540,542,540,
548,0,425,0,541,548,0,541,541,0,403,542,542,
541,542,542,0,0,0,0,0,540,546,548,0,544,
406,0,542,546,541,0,0,0,0,0,542,546,0,
0,0,542,0,541,542,541,0,0,0,425,0,544,
540,541,540,0,0,0,0,0,0,0,425,546,0,
540,548,0,541,541,540,548,0,541,549,0,0,540],

"it2":[0,0,6021,0,0,0,0,0,0,0,0,0,0,
0,0,3011,0,0,0,0,0,0,0,0,0,0,
0,0,0,0,0,0,0,0,0,0,0,0,0,
0,0,0,0,0,0,0,0,0,0,0,0,0,
0,0,0,0,0,0,0,0,0,0,3011,0,0,
0,0,6021,0,0,0,0,0,0,0,6021,0,0,
0,0,0,0,0,0,0,0,0,0,0,0,0],

"point1": [[3,5],[9,5],[9,4],[8,4],[8,3],[6,3],[6,2],[3,2],[3,0],[9,0]],
"point2": [[3,5],[9,5],[9,4],[8,4],[8,3],[6,3],[6,2],[3,2],[3,0],[9,0]]

}
