{
"row":13,
"col":7,
"isloop":0,
"datas":[2,2,1,1,1,1,1,1,1,1,1,2,2,
2,2,1,4,4,4,4,4,4,4,1,2,2,
2,2,1,1,4,1,1,1,1,1,1,2,2,
2,2,2,2,2,1,2,2,2,2,2,2,2,
2,2,2,2,2,1,2,2,2,2,2,2,2,
2,2,2,2,2,0,2,2,2,2,2,2,2,
2,2,2,2,2,2,2,2,2,2,2,2,2],

"it1":[541,540,0,0,0,0,0,0,0,0,0,542,542,
546,540,0,0,0,0,0,0,0,0,0,549,0,
0,541,0,0,0,0,0,0,0,0,0,546,542,
546,540,542,542,542,0,545,546,542,546,542,0,0,
0,542,540,550,0,0,0,0,542,0,542,540,546,
546,406,0,0,0,0,542,548,0,406,0,544,0,
0,0,0,548,0,542,549,0,542,0,0,0,542],

"it2":[0,0,0,0,0,0,0,0,0,0,0,0,0,
0,0,0,0,0,0,0,0,0,0,0,0,0,
0,0,0,0,0,0,0,0,0,0,0,0,0,
0,403,0,0,0,0,0,0,0,0,0,0,0,
0,0,0,0,0,0,0,0,0,0,0,0,0,
0,0,0,0,0,0,0,0,0,0,0,0,0,
0,0,0,0,0,0,0,0,0,0,0,0,0],

"point1": [[3,2],[2,2],[2,0],[10,0],[10,2],[5,2],[5,4]],
"point2": [[3,2],[2,2],[2,0],[10,0],[10,2],[5,2],[5,4]]

}
