{
"row":13,
"col":7,
"isloop":0,
"datas":[1,2,1,1,1,1,1,1,1,1,1,1,2,
1,2,2,2,2,2,2,2,2,2,2,1,2,
1,2,2,2,2,2,2,2,2,2,2,1,2,
1,1,1,1,1,1,1,1,1,1,1,1,1,
2,2,2,2,2,2,1,2,2,2,2,2,0,
2,2,2,2,2,2,1,2,2,2,2,2,2,
1,1,1,1,1,1,1,2,2,2,2,2,2],

"it1":[0,545,0,0,0,0,0,0,0,0,0,0,546,
0,0,545,546,550,0,542,551,0,547,0,0,0,
0,401,0,0,0,0,542,0,0,541,542,0,542,
0,0,0,0,0,0,0,0,0,0,0,0,0,
551,0,403,546,551,0,0,551,0,546,541,545,0,
0,0,542,0,0,0,0,0,0,0,545,0,0,
0,0,0,0,0,0,0,401,548,0,0,547,0],

"it2":[0,0,0,0,0,0,0,0,0,0,0,0,0,
0,0,0,0,0,0,0,0,0,0,0,0,0,
0,0,0,0,0,0,5021,0,0,0,0,0,0,
0,0,0,0,0,0,0,0,0,0,0,0,0,
0,0,0,0,0,5021,0,5021,0,0,0,0,0,
0,0,0,0,0,0,0,0,0,0,0,0,0,
0,0,0,0,0,0,0,0,0,0,0,0,0],

"point1": [[0,6],[6,6],[6,3],[12,3]],
"point2": [[0,0],[0,3],[12,3]],
"point3": [[2,0],[11,0],[11,3],[12,3]]

}
