{
"row":13,
"col":7,
"isloop":0,
"datas":[2,2,2,2,2,2,2,2,2,2,2,2,2,
2,2,1,1,1,1,1,2,1,1,1,2,2,
2,2,1,2,2,2,1,2,1,2,1,2,2,
2,2,1,2,2,2,1,2,1,2,1,2,2,
1,1,1,1,1,1,1,2,1,1,1,1,1,
2,2,1,2,2,2,2,2,2,2,1,2,0,
2,2,1,1,1,1,1,1,1,1,1,2,2],

"it1":[550,0,541,541,548,0,540,541,542,549,0,425,546,
0,0,0,0,0,0,0,540,0,0,0,540,0,
550,0,0,545,550,0,0,540,0,540,0,540,541,
0,0,0,0,0,0,0,541,0,0,0,541,542,
0,0,0,0,0,0,0,541,0,0,0,0,0,
545,541,0,540,401,401,542,547,0,542,0,540,0,
0,540,0,0,0,0,0,0,0,0,0,540,540],

"it2":[0,0,0,0,0,0,0,0,0,0,0,6021,0,
0,0,0,0,0,0,0,0,0,0,0,0,0,
0,0,3011,0,0,0,0,0,0,0,0,0,0,
0,0,0,0,0,0,0,0,0,0,0,0,0,
0,0,0,0,0,0,0,0,0,0,0,0,0,
0,0,0,0,0,0,3011,0,0,0,0,0,0,
0,0,0,0,0,0,0,0,0,0,0,0,0],

"point1": [[0,4],[6,4],[6,1],[2,1],[2,6],[10,6],[10,1],[8,1],[8,4],[12,4]],
"point2": [[0,4],[6,4],[6,1],[2,1],[2,6],[10,6],[10,1],[8,1],[8,4],[12,4]]

}
