{
"row":13,
"col":7,
"isloop":0,
"datas":[2,2,1,1,1,1,1,1,1,2,2,2,2,
2,2,0,2,2,2,2,2,1,2,2,2,2,
2,2,2,2,1,1,1,1,1,1,1,2,2,
2,2,2,2,1,2,2,2,1,2,1,2,2,
2,2,1,1,1,1,1,2,1,1,1,2,2,
2,2,2,2,1,2,1,2,2,2,2,2,2,
2,2,2,2,1,1,1,2,2,2,2,2,2],

"it1":[0,0,0,0,0,0,0,0,0,434,0,0,0,
0,0,0,426,0,421,426,0,0,0,0,0,0,
0,0,433,0,0,0,0,0,0,0,0,0,0,
0,0,0,0,0,426,0,431,0,0,0,0,0,
0,0,0,0,0,0,0,0,0,0,0,0,0,
0,0,432,430,0,0,0,433,0,430,432,0,0,
0,0,0,0,0,0,0,0,0,0,0,0,0],

"it2":[0,0,0,0,0,0,0,0,0,0,0,0,0,
0,0,0,0,0,0,0,0,0,5013,0,0,0,
0,0,0,0,0,0,0,0,0,0,0,0,0,
0,0,0,7013,0,0,0,0,0,0,0,0,0,
0,0,0,0,0,0,0,0,0,0,0,0,0,
0,0,0,0,0,0,0,3013,0,0,0,0,0,
0,0,0,0,0,0,0,0,0,0,0,0,0],

"point1": [[2,4],[6,4],[6,6],[4,6],[4,2],[10,2],[10,4],[8,4],[8,0],[2,0]],
"point2": [[2,4],[6,4],[6,6],[4,6],[4,2],[10,2],[10,4],[8,4],[8,0],[2,0]]

}
