{
"row":13,
"col":7,
"isloop":0,
"datas":[2,2,2,2,2,2,1,2,2,2,2,2,2,
2,2,2,2,2,2,1,2,2,2,2,2,2,
2,2,2,2,2,2,1,2,2,2,2,2,2,
2,1,1,1,1,1,1,1,1,1,1,1,2,
2,1,2,2,2,2,2,2,2,2,2,1,2,
2,1,1,1,1,1,1,1,1,1,1,1,2,
2,2,2,2,2,2,0,2,2,2,2,2,2],

"it1":[541,540,541,542,540,401,0,550,0,551,0,545,546,
540,544,545,546,551,0,0,0,0,0,0,0,0,
541,0,0,0,0,0,0,547,0,548,0,0,542,
542,0,0,0,0,0,0,0,0,0,0,0,541,
401,0,542,542,401,549,0,401,542,548,0,0,401,
401,0,0,0,0,0,0,0,0,0,0,0,401,
541,540,541,540,541,542,0,541,542,547,0,541,542],

"it2":[],

"point1": [[6,0],[6,3],[11,3],[11,5],[6,5]],
"point2": [[6,0],[6,3],[11,3],[11,5],[6,5]],
"point3": [[6,0],[6,3],[1,3],[1,5],[6,5]],
"point4": [[6,0],[6,3],[1,3],[1,5],[6,5]]

}
