{
"row":13,
"col":7,
"isloop":0,
"datas":[2,2,2,2,2,1,1,1,1,1,1,1,2,
2,2,2,2,2,1,2,2,2,2,2,1,2,
2,2,1,1,1,1,1,1,1,1,1,1,2,
2,2,1,4,4,1,2,2,2,2,2,0,2,
2,2,1,4,4,4,2,2,2,2,2,2,2,
2,2,1,1,1,1,1,1,1,1,2,2,2,
2,2,2,2,2,2,2,2,2,2,2,2,2],

"it1":[544,550,0,542,401,0,0,0,0,0,0,0,401,
0,0,0,542,540,0,540,541,542,547,0,0,546,
540,410,0,0,0,0,0,0,0,0,0,0,0,
545,546,0,0,0,0,551,0,551,0,545,0,401,
0,0,0,0,0,0,0,0,0,0,0,540,546,
541,0,0,0,0,0,0,0,0,0,541,540,0,
541,540,541,542,541,542,547,0,548,0,541,540,542],

"it2":[],

"point1": [[9,5],[2,5],[2,2],[11,2]],
"point2": [[9,5],[2,5],[2,2],[11,2]],
"point3": [[5,3],[5,0],[11,0],[11,2]],
"point4": [[5,3],[5,0],[11,0],[11,2]]

}
