{
"row":13,
"col":7,
"isloop":0,
"datas":[2,2,2,2,2,2,2,2,2,2,2,2,2,
2,1,1,1,1,1,1,1,1,1,1,1,2,
2,1,2,2,2,2,1,2,2,2,2,1,2,
2,1,2,2,2,2,1,2,2,2,2,1,2,
2,1,2,2,2,2,1,2,2,2,2,1,2,
2,1,2,2,2,2,1,2,2,2,2,1,2,
2,2,2,2,2,2,2,2,2,2,2,0,2],

"it1":[541,541,549,0,547,0,548,0,541,542,541,404,545,
425,0,0,0,0,0,0,0,0,0,0,0,0,
546,0,544,542,548,0,0,551,0,551,0,0,541,
0,0,0,542,542,541,0,0,0,0,0,0,541,
0,0,542,547,0,542,0,547,0,551,0,0,544,
541,0,542,541,542,542,0,548,0,0,0,0,0,
542,541,541,542,547,0,547,0,541,542,542,0,540],

"it2":[0,0,0,0,0,0,0,0,0,0,0,1060,0,
6041,0,0,0,0,0,0,0,0,0,0,0,0,
0,0,0,0,0,0,0,0,0,0,0,0,0,
0,0,0,0,0,0,0,0,0,0,0,0,0,
0,0,0,0,0,0,0,0,0,0,0,0,0,
0,0,0,0,0,0,0,0,0,0,0,0,0,
0,0,0,0,0,0,0,0,0,0,0,0,0],

"point1": [[1,5],[1,1],[11,1],[11,5]],
"point2": [[1,5],[1,1],[11,1],[11,5]],
"point3": [[6,5],[6,1],[11,1],[11,5]],
"point4": [[6,5],[6,1],[11,1],[11,5]]

}
