{
"row":13,
"col":7,
"isloop":1,
"datas":[2,2,2,2,1,1,1,1,1,2,2,2,2,
2,2,2,2,1,2,2,2,1,2,2,2,2,
2,2,1,1,1,1,1,2,1,2,2,2,2,
2,2,1,2,1,2,1,2,1,2,2,2,2,
2,2,1,2,1,1,1,1,1,2,2,2,2,
2,2,1,2,2,2,1,2,2,2,2,2,2,
2,2,1,1,1,1,1,2,2,2,2,2,2],

"it1":[545,546,551,0,0,0,0,0,0,550,0,546,545,
0,0,0,0,0,542,542,542,0,0,0,0,0,
541,542,0,0,0,0,0,542,0,546,550,0,401,
541,542,0,542,0,425,0,542,0,0,0,0,401,
540,0,0,542,0,0,0,0,0,542,545,546,546,
545,546,0,542,542,542,0,545,551,0,0,0,0,
0,0,0,0,0,0,0,0,0,0,401,542,401],

"it2":[0,0,0,0,0,0,0,0,0,0,0,0,0,
0,0,0,0,0,0,0,0,0,0,0,0,0,
0,0,0,0,0,0,0,0,0,0,0,0,0,
0,0,0,0,0,2041,0,0,0,0,0,0,0,
0,0,0,0,0,0,0,0,0,0,0,0,0,
0,0,0,0,0,0,0,0,0,0,0,0,0,
0,0,0,0,0,0,0,0,0,0,0,0,0],

"point1": [[2,6],[6,6],[6,2],[2,2],[2,6]],
"point2": [[2,6],[6,6],[6,2],[2,2],[2,6]],
"point3": [[4,4],[4,0],[8,0],[8,4],[4,4]],
"point4": [[4,4],[4,0],[8,0],[8,4],[4,4]]

}
