{
"row":13,
"col":7,
"isloop":0,
"datas":[2,2,1,1,1,1,1,2,2,2,2,2,2,
2,2,1,2,2,2,1,1,2,2,2,2,2,
2,2,1,1,2,2,2,1,1,2,2,2,2,
2,2,2,1,1,2,2,2,1,1,2,2,2,
2,2,2,2,1,1,2,2,2,1,1,2,2,
2,2,2,2,2,1,1,1,2,2,1,1,2,
2,2,2,2,2,2,2,0,2,2,2,2,2],

"it1":[434,0,0,0,0,0,0,429,0,0,0,0,0,
0,0,0,0,434,0,0,0,422,0,0,0,0,
429,0,0,0,0,0,424,0,0,426,0,0,0,
0,433,0,0,0,423,434,0,0,0,424,433,0,
0,0,0,421,0,0,0,0,0,0,0,0,0,
0,0,0,432,421,0,0,0,422,0,0,0,0,
0,0,0,0,424,426,0,0,428,429,0,0,6011],

"it2":[0,0,0,0,0,0,0,0,0,0,0,0,0,
0,0,0,0,0,0,0,0,0,0,0,0,0,
0,0,0,0,0,0,0,0,0,0,0,0,0,
0,0,0,0,0,0,7013,0,0,0,0,0,0,
0,0,0,0,0,0,0,0,0,0,0,0,0,
0,0,0,0,0,0,0,0,0,0,0,0,0,
0,0,0,0,0,0,0,0,0,0,0,0,0],

"point1": [[11,5],[10,5],[10,4],[9,4],[9,3],[8,3],[8,2],[7,2],[7,1],[6,1],[6,0],[2,0],[2,2],[3,2],[3,3],[4,3],[4,4],[5,4],[5,5],[7,5]],
"point2": [[11,5],[10,5],[10,4],[9,4],[9,3],[8,3],[8,2],[7,2],[7,1],[6,1],[6,0],[2,0],[2,2],[3,2],[3,3],[4,3],[4,4],[5,4],[5,5],[7,5]]

}
