{
"row":13,
"col":7,
"isloop":0,
"datas":[1,1,1,1,1,1,1,1,1,1,1,2,2,
1,2,2,1,1,2,1,1,1,1,1,2,2,
1,2,2,1,0,2,1,2,2,2,2,2,2,
1,1,1,1,2,2,1,1,1,1,1,1,1,
2,2,2,2,2,2,2,2,2,2,2,2,1,
2,1,1,1,1,1,1,1,1,1,1,1,1,
2,2,2,2,2,2,2,2,2,2,2,2,2],

"it1":[0,0,0,0,0,0,0,0,0,0,0,411,401,
0,550,0,0,0,0,0,0,0,0,0,551,0,
0,0,0,0,0,546,0,542,548,0,540,0,0,
0,0,0,0,542,0,0,0,0,0,0,0,0,
542,549,0,547,0,401,403,548,0,547,0,404,0,
410,0,0,0,0,0,0,0,0,0,0,0,0,
547,0,540,548,0,547,0,541,401,549,0,540,542],

"it2":[0,0,0,0,0,0,0,0,0,0,0,0,0,
0,0,0,0,0,0,0,0,0,0,0,0,0,
0,0,0,0,0,0,0,0,0,0,0,0,0,
0,0,0,0,0,0,0,0,0,0,0,0,0,
0,0,0,0,0,0,0,0,0,0,0,1100,0,
0,0,0,0,0,0,0,0,0,0,0,0,0,
0,0,0,0,0,0,0,0,0,0,0,0,0],

"point1": [[1,5],[12,5],[12,3],[6,3],[6,1],[10,1],[10,0],[0,0],[0,3],[3,3],[3,1],[4,1]],
"point2": [[1,5],[12,5],[12,3],[6,3],[6,1],[10,1],[10,0],[0,0],[0,3],[3,3],[3,1],[4,1]]

}
