{
"row":13,
"col":7,
"isloop":0,
"datas":[2,2,2,2,2,2,2,2,2,2,2,2,2,
2,2,2,2,1,1,1,1,1,2,2,2,2,
2,2,2,2,1,2,2,2,1,2,2,2,2,
2,2,2,2,1,2,2,1,1,2,2,2,2,
2,2,2,2,1,2,2,1,2,2,2,2,2,
2,1,1,1,1,2,2,1,1,1,1,2,2,
2,2,2,2,2,2,2,2,2,2,0,2,2],

"it1":[544,544,542,425,542,547,0,547,0,541,403,550,0,
0,0,546,546,0,0,0,0,0,545,545,0,0,
401,541,0,0,0,540,541,425,0,0,0,542,401,
546,546,541,541,0,545,546,0,0,549,0,542,541,
0,0,542,425,0,0,0,0,542,541,542,542,541,
425,0,0,0,0,540,540,0,0,0,0,0,541,
540,541,540,401,541,547,0,548,0,541,0,547,0],

"it2":[0,0,0,6021,0,0,0,0,0,0,0,0,0,
0,0,0,0,0,0,0,0,0,0,0,0,0,
0,0,0,0,0,0,0,2021,0,0,0,0,0,
0,0,0,0,0,0,0,0,0,0,0,0,0,
0,0,0,2021,0,0,0,0,0,0,0,0,0,
6021,0,0,0,0,0,0,0,0,0,0,0,0,
0,0,0,0,0,0,0,0,0,0,0,0,0],

"point1": [[1,5],[4,5],[4,1],[8,1],[8,3],[7,3],[7,5],[10,5]],
"point2": [[1,5],[4,5],[4,1],[8,1],[8,3],[7,3],[7,5],[10,5]]

}
