{
"row":13,
"col":7,
"isloop":0,
"datas":[2,2,2,2,2,2,1,1,1,1,1,1,2,
2,2,2,2,2,2,1,2,2,2,2,2,2,
2,2,2,2,2,2,1,2,2,2,2,2,2,
2,1,1,1,1,1,1,1,1,1,1,1,2,
2,2,2,2,2,2,1,0,2,2,2,2,2,
2,2,2,2,2,2,1,2,2,2,2,2,2,
2,1,1,1,1,1,1,2,2,2,2,2,2],

"it1":[541,542,544,545,540,540,0,0,0,0,0,0,0,
545,546,0,0,550,0,0,540,541,550,0,546,542,
0,0,540,541,0,0,0,540,541,0,0,0,541,
540,0,0,0,0,0,0,0,0,0,0,0,540,
540,546,545,546,541,542,0,0,540,546,550,0,544,
541,0,0,0,540,541,0,547,0,0,0,0,0,
540,0,0,0,0,0,0,540,542,542,547,0,540],

"it2":[],

"point1": [[11,0],[6,0],[6,3],[7,3]],
"point2": [[11,3],[7,3]],
"point3": [[1,6],[6,6],[6,3],[7,3]],
"point4": [[1,3],[7,3]]

}
