{
"row":13,
"col":7,
"isloop":0,
"datas":[2,1,1,1,1,2,2,2,1,1,1,1,2,
2,1,2,2,2,2,2,2,2,2,2,1,2,
2,1,2,2,2,2,2,2,2,2,2,1,2,
2,1,2,2,2,2,2,2,2,2,2,1,2,
2,1,2,2,2,2,2,2,2,2,2,1,2,
2,1,1,1,1,1,1,1,1,1,1,1,2,
2,2,2,2,2,2,0,2,2,2,2,2,2],

"it1":[544,0,0,0,0,411,0,410,0,0,0,0,540,
0,0,542,540,542,542,540,540,551,0,545,0,544,
542,0,540,542,540,401,542,401,0,0,0,0,0,
544,0,401,548,0,548,0,542,542,401,542,0,540,
0,0,404,541,541,548,0,548,0,541,404,0,541,
542,0,0,0,0,0,0,0,0,0,0,0,541,
540,549,0,540,401,542,0,540,548,0,540,541,541],

"it2":[0,0,0,0,0,0,0,0,0,0,0,0,0,
0,0,0,0,0,0,0,0,0,0,0,0,0,
0,0,0,0,0,0,0,0,0,0,0,0,0,
0,0,0,0,0,0,0,0,0,0,0,0,0,
0,0,1010,0,0,0,0,0,0,0,1010,0,0,
0,0,0,0,0,0,0,0,0,0,0,0,0,
0,0,0,403,0,0,0,0,0,0,0,0,0],

"point1": [[4,0],[1,0],[1,5],[6,5]],
"point2": [[8,0],[11,0],[11,5],[6,5]],
"point3": [[4,0],[1,0],[1,5],[6,5]],
"point4": [[8,0],[11,0],[11,5],[6,5]]

}
