{
"row":13,
"col":7,
"isloop":0,
"destroyed1":[[3,5],[5,5]],
"destroyed2":[[3,1],[5,1]],
"datas":[1,2,2,2,2,2,2,2,2,2,2,2,2,
1,2,2,2,2,1,1,2,2,2,2,2,2,
1,2,2,2,2,2,1,2,2,2,2,2,2,
1,1,1,1,1,1,1,1,1,1,1,1,1,
1,2,2,2,2,2,1,2,2,2,2,2,0,
1,2,2,2,2,1,1,2,2,2,2,2,2,
1,2,2,2,2,2,2,2,2,2,2,2,2],

"it1":[0,544,546,547,0,547,0,551,0,401,542,545,546,
0,0,0,400,0,0,0,0,0,542,542,0,0,
0,401,542,0,0,541,0,549,0,549,0,541,0,
0,0,0,0,0,0,0,0,0,0,0,0,0,
0,544,401,542,542,541,0,551,0,549,0,546,0,
0,0,542,400,0,0,0,0,0,549,0,0,541,
0,401,540,0,0,541,541,547,0,547,0,548,0],

"it2":[0,0,0,0,0,0,0,0,0,0,0,0,0,
0,0,0,0,0,0,0,0,0,0,0,0,0,
0,0,0,0,0,3021,0,0,0,0,0,0,0,
0,0,0,0,0,0,0,0,0,0,0,0,0,
0,0,0,0,0,3021,0,0,0,0,0,0,0,
0,0,0,0,0,0,0,0,0,0,0,0,0,
0,0,0,0,0,0,0,0,0,0,0,0,0],

"point1": [[0,6],[0,3],[12,3]],
"point2": [[0,0],[0,3],[12,3]],
"point3": [[5,5],[6,5],[6,3],[12,3]],
"point4": [[5,1],[6,1],[6,3],[12,3]]

}
