{
"row":13,
"col":7,
"isloop":0,
"datas":[2,2,2,1,1,1,1,1,1,1,2,2,2,
2,2,2,0,2,2,2,2,2,1,2,2,2,
2,2,2,1,1,1,1,1,1,1,2,2,2,
2,2,2,1,2,2,2,2,2,2,2,2,2,
2,2,2,1,1,1,1,1,1,1,2,2,2,
2,2,2,2,2,2,2,2,2,1,2,2,2,
2,2,2,1,1,1,1,1,1,1,2,2,2],

"it1":[406,0,542,0,0,0,0,0,0,0,411,541,542,
0,0,542,0,540,541,0,541,541,0,541,541,541,
549,0,410,0,0,0,0,0,0,0,541,551,0,
541,548,0,0,541,542,549,0,541,541,541,0,0,
545,542,542,0,0,0,0,0,0,0,411,549,0,
0,542,542,542,542,542,542,547,0,0,542,406,0,
541,403,410,0,0,0,0,0,0,0,542,0,0],

"it2":[],

"point1": [[3,6],[9,6],[9,4],[3,4],[3,2],[9,2],[9,0],[3,0]],
"point2": [[3,6],[9,6],[9,4],[3,4],[3,2],[9,2],[9,0],[3,0]]

}
