{
"row":13,
"col":7,
"isloop":0,
"destroyed1":[[4,3],[5,2]],
"destroyed2":[[4,3],[5,2]],
"destroyed3":[[7,3],[7,2]],
"destroyed4":[[7,3],[7,2]],
"datas":[1,1,1,1,1,1,1,1,1,1,1,1,1,
1,2,2,2,2,1,2,1,2,2,2,2,1,
1,2,2,2,2,1,2,1,2,2,2,2,1,
1,2,2,2,2,2,2,2,2,2,2,2,1,
1,2,2,2,2,2,2,2,2,2,2,2,1,
1,1,1,1,1,1,1,1,1,1,1,1,1,
2,2,2,2,2,2,0,2,2,2,2,2,2],

"it1":[0,0,0,0,0,0,0,0,0,0,0,0,0,
0,0,423,423,0,0,0,0,0,423,423,0,0,
0,423,434,0,423,0,421,0,423,434,0,423,0,
0,423,0,0,407,0,432,407,0,0,0,423,0,
0,0,423,423,0,0,0,0,0,423,423,0,0,
0,0,0,0,0,0,0,0,0,0,0,0,0,
0,429,0,0,429,0,0,429,0,0,429,0,0],

"it2":[0,0,0,0,0,0,0,0,0,0,0,0,0,
0,0,0,0,0,0,0,0,0,0,0,0,0,
0,0,0,0,0,0,0,0,0,0,0,0,0,
0,0,0,0,0,0,0,0,0,0,0,0,0,
0,0,0,0,0,0,0,0,0,0,0,0,0,
0,0,0,0,0,0,0,0,0,0,0,0,0,
6011,0,0,0,0,0,0,0,0,0,0,0,6011],

"point1": [[5,2],[5,0],[12,0],[12,5],[6,5]],
"point2": [[5,2],[5,0],[12,0],[12,5],[6,5]],
"point3": [[7,2],[7,0],[0,0],[0,5],[6,5]],
"point4": [[7,2],[7,0],[0,0],[0,5],[6,5]]

}
