{
"row":13,
"col":7,
"isloop":0,
"datas":[2,1,1,1,1,4,4,2,2,2,2,2,2,
2,0,2,2,1,2,4,2,2,2,2,2,2,
2,2,4,2,1,1,1,1,1,1,1,1,2,
2,2,4,2,1,1,2,4,2,2,2,1,2,
1,1,1,1,1,1,4,4,2,2,2,1,2,
1,1,1,1,1,1,2,2,2,2,2,2,2,
2,2,2,2,2,2,2,2,2,2,2,2,2],

"it1":[540,0,0,0,0,0,0,547,0,550,0,542,541,
545,0,549,0,0,540,0,540,0,0,0,540,544,
0,544,0,545,0,0,0,0,0,0,0,0,0,
541,0,0,0,0,0,542,0,546,548,0,0,545,
0,0,0,0,0,0,0,0,0,545,542,0,0,
0,0,0,0,0,0,549,0,545,0,544,550,0,
548,0,542,547,0,541,547,0,0,542,0,0,0],

"it2":[],

"point1": [[11,4],[11,2],[5,2],[5,5],[0,5],[0,4],[4,4],[4,0],[1,0]],
"point2": [[11,4],[11,2],[5,2],[5,5],[0,5],[0,4],[4,4],[4,0],[1,0]],
"point3": [[11,4],[11,2],[5,2],[5,5],[0,5],[0,4],[4,4],[4,0],[1,0]]

}
