{
"row":13,
"col":7,
"isloop":0,
"datas":[2,2,2,2,2,2,2,2,2,2,2,2,2,
2,2,2,2,2,2,2,2,2,2,2,2,2,
2,2,2,1,1,1,1,1,2,2,2,2,2,
2,2,2,2,2,1,0,1,2,2,2,2,2,
2,2,2,2,2,1,1,1,2,2,2,2,2,
2,2,2,2,2,2,2,2,2,2,2,2,2,
2,2,2,2,2,2,2,2,2,2,2,2,2],

"it1":[550,0,541,551,0,545,546,544,550,0,545,541,541,
0,0,544,0,0,0,0,0,0,0,0,544,401,
547,0,0,0,0,0,0,0,548,0,0,0,545,
545,540,542,549,0,0,0,0,549,0,542,540,0,
0,544,0,548,0,0,0,0,547,0,546,547,0,
401,0,545,550,0,544,546,545,551,0,0,550,0,
541,541,0,0,0,0,0,0,0,0,541,0,0],

"it2":[],

"point1": [[3,2],[5,2],[5,4],[7,4],[7,2],[6,2]],
"point2": [[3,2],[5,2],[5,4],[7,4],[7,2],[6,2]]

}
