{
"row":13,
"col":7,
"isloop":0,
"datas":[2,2,2,2,2,2,2,2,2,2,3,3,1,
2,2,2,4,2,4,2,4,2,2,3,3,0,
2,2,2,2,2,2,2,4,2,2,3,4,4,
2,2,2,2,2,2,2,4,2,2,3,3,2,
2,4,4,2,2,2,2,2,2,4,4,3,3,
2,2,2,4,4,2,2,2,2,4,4,3,1,
2,2,2,2,2,2,2,2,2,2,2,2,2],

"it1":[410,547,0,410,549,0,544,548,0,545,0,0,0,
550,0,540,0,540,0,0,0,541,0,0,0,0,
0,0,406,0,545,551,0,0,550,0,0,0,0,
544,540,0,0,0,0,0,0,0,0,0,0,411,
0,0,0,540,549,0,546,547,0,0,0,0,0,
547,0,544,0,0,545,0,542,546,0,0,0,0,
401,542,0,541,540,0,548,0,0,540,547,0,411],

"it2":[],

"point1": [[12,5],[12,0]],
"point2": [[12,5],[12,0]],
"point3": [[12,5],[12,0]]

}
