{
"row":13,
"col":7,
"isloop":0,
"datas":[4,4,2,4,4,4,2,4,4,4,2,4,4,
2,4,4,4,2,4,4,4,2,4,4,4,2,
4,4,4,4,4,4,4,4,4,4,2,4,4,
2,1,1,1,1,1,1,1,1,1,1,1,1,
4,4,4,4,4,4,4,4,4,4,2,4,4,
2,4,4,4,2,4,4,4,2,4,4,4,2,
4,4,2,4,4,4,2,4,4,4,2,4,4],

"it1":[0,0,401,0,0,0,401,0,0,0,401,0,0,
401,0,0,0,401,0,0,0,401,0,0,0,0,
0,0,0,0,0,0,0,0,0,0,540,0,0,
401,0,0,0,0,0,0,0,0,0,0,0,0,
0,0,0,0,0,0,0,0,0,0,540,0,0,
401,0,0,0,401,0,0,0,401,0,0,0,401,
0,0,401,0,0,0,401,0,0,0,401,0,0],

"it2":[],

"point1": [[1,3],[12,3]],
"point2": [[1,3],[12,3]],
"point3": [[1,3],[12,3]]

}
