{
"row":13,
"col":7,
"isloop":0,
"datas":[2,2,2,2,2,2,2,2,2,2,2,2,2,
2,2,2,2,2,2,2,2,2,2,2,2,2,
2,1,1,1,1,1,2,1,1,1,1,1,2,
2,1,2,2,2,1,2,1,2,2,2,1,2,
2,1,2,2,2,0,2,1,2,2,2,1,2,
2,1,1,1,1,1,1,1,1,1,1,1,2,
2,2,2,2,2,2,2,2,2,2,2,2,2],

"it1":[0,0,0,0,0,0,0,0,0,0,0,0,0,
0,421,426,0,426,0,0,0,0,0,0,0,0,
421,0,0,0,0,0,425,0,0,0,0,0,0,
431,0,4011,4011,4011,0,432,0,0,0,0,0,0,
0,0,4011,4011,4011,0,0,0,0,0,0,0,0,
425,0,0,0,0,0,0,0,0,0,0,0,0,
0,421,426,0,426,0,0,0,0,0,0,0,0],

"it2":[0,0,0,0,0,0,0,0,0,0,0,0,0,
0,0,0,0,0,0,0,0,0,0,0,0,0,
0,0,0,0,0,0,3013,0,0,0,0,0,0,
0,0,0,0,0,0,0,0,0,0,0,0,0,
0,0,0,0,0,0,0,0,0,0,0,0,0,
3013,0,0,0,0,0,0,0,0,0,0,0,0,
0,0,0,0,0,0,0,0,0,0,0,0,0],

"point1": [[7,4],[7,2],[11,2],[11,5],[1,5],[1,2],[5,2],[5,3]],
"point2": [[7,4],[7,2],[11,2],[11,5],[1,5],[1,2],[5,2],[5,3]]

}
