{
"row":13,
"col":7,
"isloop":0,
"datas":[2,2,2,2,2,2,2,2,2,2,2,2,2,
2,1,1,1,1,1,1,1,1,1,1,1,2,
2,1,2,2,2,2,2,2,2,2,2,0,2,
2,1,2,2,2,2,2,2,2,2,2,2,2,
2,1,2,2,2,2,2,2,2,2,2,2,2,
2,1,2,2,2,2,2,2,2,2,2,2,2,
2,2,2,2,2,2,2,2,2,2,2,2,2],

"it1":[404,582,588,0,581,586,0,580,588,0,580,582,404,
583,0,0,0,0,0,0,0,0,0,0,0,585,
0,0,401,585,587,0,589,0,588,0,0,0,0,
584,0,580,0,590,0,0,0,582,587,0,586,0,
0,0,590,0,0,0,584,581,589,0,401,587,0,
580,0,0,0,401,581,0,585,0,0,587,0,403,
404,587,0,581,586,0,580,0,582,588,0,580,404],

"it2":[1320,0,0,0,0,0,0,0,0,0,0,0,1320,
0,0,0,0,0,0,0,0,0,0,0,0,0,
0,0,0,0,0,0,0,0,0,0,0,0,0,
0,0,0,0,0,0,0,0,0,0,0,0,0,
0,0,0,0,0,0,0,0,0,0,0,0,0,
0,0,0,0,0,0,0,0,0,0,0,0,0,
1320,0,0,0,0,0,0,0,0,0,0,0,1320],

"sandwave":[1,2,3,4,5,6,7,8,9,10,11,12,13,14,15,16,17,18,19,20,21,22,23,24,25,26,27,28,29,30],
"sandhole1":[[0,6],[3,5]],
"sandhole2":[[5,4],[0,0]],
"sandhole3":[[12,6],[7,3]],
"sandhole4":[[9,2],[12,0]],

"point1": [[1,5],[1,1],[11,1]],
"point2": [[1,5],[1,1],[11,1]],
"point3": [[1,5],[1,1],[11,1]]

}
