{
"row":13,
"col":7,
"isloop":0,
"datas":[2,2,2,2,2,2,2,2,2,2,2,2,2,
1,1,1,1,1,1,1,2,2,2,2,2,2,
1,2,2,2,2,2,1,2,2,2,2,2,2,
1,1,1,2,2,2,1,2,2,2,2,2,2,
2,2,0,2,2,2,1,2,2,2,2,2,2,
2,1,1,1,1,1,1,2,2,2,2,2,2,
2,1,1,1,1,1,1,2,2,2,2,2,2],

"it1":[424,0,424,422,0,429,0,433,0,429,0,0,0,
0,0,0,0,0,0,0,0,0,434,0,434,0,
0,429,0,425,425,421,0,423,421,0,0,0,0,
0,0,0,425,425,432,0,433,0,432,429,0,0,
429,0,0,425,425,0,0,0,0,0,421,434,0,
432,0,0,0,0,0,0,433,0,434,0,0,0,
0,0,0,0,0,0,0,0,0,0,0,0,0],

"it2":[0,0,0,0,0,0,0,0,0,0,0,0,0,
0,0,0,0,0,0,0,0,0,0,0,0,0,
0,0,0,4013,4013,0,0,0,0,0,0,0,0,
0,0,0,4013,4013,0,0,0,0,0,0,0,0,
0,0,0,7013,7013,0,0,0,0,0,0,0,0,
0,0,0,0,0,0,0,0,0,0,0,0,0,
0,0,0,0,0,0,0,0,0,0,0,0,0],

"point1": [[6,6],[1,6],[1,5],[6,5],[6,1],[0,1],[0,3],[2,3]],
"point2": [[6,6],[1,6],[1,5],[6,5],[6,1],[0,1],[0,3],[2,3]]

}
