{
"row":13,
"col":7,
"isloop":0,
"datas":[2,1,1,1,1,1,1,1,1,1,2,2,2,
2,1,2,1,2,2,2,2,2,2,2,2,2,
2,1,2,1,1,1,1,1,1,1,1,1,1,
1,1,2,2,2,2,2,2,2,2,2,2,2,
0,1,2,1,1,1,1,1,1,1,1,1,1,
2,1,2,1,2,2,2,2,2,2,2,2,2,
2,1,1,1,1,1,1,1,1,1,2,2,2],

"it1":[582,0,0,0,0,0,0,0,0,0,581,581,581,
401,0,582,0,581,588,0,582,581,582,581,582,581,
412,0,585,0,0,0,0,0,0,0,0,0,0,
0,0,0,581,412,582,412,582,412,582,412,582,0,
0,0,585,0,0,0,0,0,0,0,0,0,0,
412,0,0,0,581,582,588,0,581,582,581,406,0,
401,0,0,0,0,0,0,0,0,0,581,0,0],

"it2":[0,0,0,0,0,0,0,0,0,0,0,0,0,
0,0,0,0,0,5021,0,0,0,0,0,0,0,
0,0,0,0,0,0,0,0,0,0,0,0,0,
0,0,2021,0,0,5021,0,0,0,0,0,0,0,
0,0,0,0,0,0,0,0,0,0,0,0,0,
0,0,0,0,0,5021,0,0,0,0,0,0,0,
0,0,0,0,0,0,0,0,0,0,0,0,0],

"point1": [[12,4],[3,4],[3,6],[1,6],[1,3],[0,3]],
"point2": [[12,2],[3,2],[3,0],[1,0],[1,3],[0,3]],
"point3": [[9,6],[1,6],[1,3],[0,3]],
"point4": [[9,0],[1,0],[1,3],[0,3]]

}
