{
"row":13,
"col":7,
"isloop":0,
"datas":[2,2,2,2,2,2,2,2,2,2,2,2,2,
2,1,1,1,1,1,1,1,2,2,2,2,2,
2,2,2,2,1,2,2,1,2,2,2,2,2,
2,2,2,2,1,2,2,1,1,1,1,1,1,
2,2,2,2,1,2,2,1,2,2,2,2,0,
2,1,1,1,1,1,1,1,2,2,2,2,2,
2,2,2,2,2,2,2,2,2,2,2,2,2],

"it1":[580,580,582,580,580,581,587,0,583,584,401,581,401,
581,0,0,0,0,0,0,0,0,0,580,581,582,
580,581,583,584,0,401,582,0,401,412,580,412,580,
580,580,0,0,0,590,0,0,0,0,0,0,0,
580,580,0,581,0,0,0,0,412,580,412,581,0,
585,0,0,0,0,0,0,0,584,585,580,586,0,
0,580,580,581,580,581,582,580,0,0,401,581,401],

"it2":[0,0,0,0,0,0,0,0,0,0,0,0,0,
0,0,0,0,0,0,0,0,0,0,0,0,0,
0,0,0,0,0,0,3011,0,0,0,0,0,0,
0,0,0,0,0,3011,0,0,0,0,0,0,0,
0,0,0,0,0,3011,0,0,0,0,0,0,0,
0,0,0,0,0,0,0,0,0,0,0,0,0,
0,0,0,0,0,0,0,0,0,0,0,0,0],

"sandwave":[1,2,3,4,5,6,7,8,9,10,11,12,13,14,15,16,17,18,19,20,21,22,23,24,25,26,27,28,29,30],
"sandhole1":[[3,4],[9,4],[11,4],[3,2],[8,2],[10,2]],

"point1": [[1,5],[7,5],[7,3],[12,3]],
"point2": [[1,1],[7,1],[7,3],[12,3]],
"point3": [[4,3],[4,5],[7,5],[7,3],[12,3]],
"point4": [[4,3],[4,1],[7,1],[7,3],[12,3]]

}
