{
"row":13,
"col":7,
"isloop":0,
"datas":[2,2,2,2,2,2,2,2,2,2,2,2,2,
2,1,1,1,1,1,1,1,1,1,1,1,2,
2,1,2,2,2,2,2,2,2,2,2,1,2,
2,1,2,2,2,2,2,2,2,2,2,1,1,
2,1,2,2,2,2,2,2,2,2,2,1,0,
2,1,1,1,1,1,1,1,1,1,1,1,2,
2,2,2,2,2,2,2,2,2,2,2,2,2],

"it1":[432,0,426,0,422,0,425,422,0,426,0,0,431,
0,0,0,0,0,0,0,0,0,0,0,0,0,
421,0,429,0,422,0,0,422,0,429,0,0,421,
425,0,425,0,426,0,424,426,0,0,425,0,0,
421,0,429,0,422,0,0,422,0,429,0,0,0,
432,0,0,0,0,0,0,0,0,0,0,0,431,
0,0,426,0,422,0,425,422,0,426,0,0,0],

"it2":[0,0,0,0,0,0,3013,0,0,0,0,0,0,
0,0,0,0,0,0,0,0,0,0,0,0,0,
0,0,0,0,0,0,0,0,0,0,0,0,0,
7013,0,3013,0,0,0,0,0,0,0,3013,0,0,
0,0,0,0,0,0,0,0,0,0,0,0,0,
0,0,0,0,0,0,0,0,0,0,0,0,0,
0,0,0,0,0,0,3013,0,0,0,0,0,0],

"point1": [[1,3],[1,5],[11,5],[11,3],[12,3]],
"point2": [[1,3],[1,5],[11,5],[11,3],[12,3]],
"point3": [[1,3],[1,1],[11,1],[11,3],[12,3]],
"point4": [[1,3],[1,1],[11,1],[11,3],[12,3]]

}
