{
"row":13,
"col":7,
"isloop":0,
"datas":[2,1,1,1,1,1,1,1,1,1,1,1,2,
2,1,2,2,2,2,2,2,2,2,2,0,2,
2,1,2,2,2,2,2,2,2,2,2,2,2,
2,1,1,1,1,1,1,1,1,1,1,2,2,
2,2,2,2,2,2,2,2,2,2,1,2,2,
2,1,1,1,1,1,1,1,1,1,1,2,2,
2,2,2,2,2,2,2,2,2,2,2,2,2],

"it1":[425,0,0,0,0,0,0,0,0,0,0,0,421,
423,0,434,0,430,433,0,425,433,0,428,0,431,
430,0,0,0,0,0,0,421,0,0,426,0,0,
0,0,0,0,0,0,0,0,0,0,0,425,421,
432,429,0,425,422,0,425,429,0,425,0,430,431,
0,0,0,0,0,0,0,0,0,0,0,0,0,
6011,429,0,427,426,0,421,426,0,427,421,425,421],

"it2":[6011,0,0,0,0,0,0,0,0,0,0,0,0,
0,0,0,0,0,0,0,3011,0,0,0,0,0,
0,0,0,0,0,0,0,0,0,0,0,0,0,
0,0,0,0,0,0,0,0,0,0,0,6011,0,
0,0,0,3011,0,0,7011,0,0,3011,0,0,0,
0,0,0,0,0,0,0,0,0,0,0,0,0,
0,0,0,0,0,0,0,0,0,0,0,6011,0],

"point1": [[1,5],[10,5],[10,3],[1,3],[1,0],[11,0]],
"point2": [[1,5],[10,5],[10,3],[1,3],[1,0],[11,0]]

}
