{
"row":13,
"col":7,
"isloop":0,
"datas":[2,1,1,1,1,1,1,1,1,2,2,2,2,
2,1,1,0,1,1,1,1,1,2,2,2,2,
2,1,1,2,2,2,2,1,1,2,2,2,2,
2,1,1,2,2,2,2,1,1,2,2,2,2,
2,1,1,2,2,2,2,1,1,2,2,2,2,
2,1,1,1,1,1,1,1,1,2,2,2,2,
2,1,1,1,1,1,1,1,1,2,2,2,2],

"it1":[0,0,0,0,0,0,0,0,0,411,588,0,582,
585,0,0,0,0,0,0,0,0,412,401,401,401,
0,0,0,586,0,584,582,0,0,412,401,403,401,
580,0,0,590,0,0,585,0,0,412,401,403,401,
412,0,0,0,0,581,0,0,0,412,401,403,401,
412,0,0,0,0,0,0,0,0,412,401,401,401,
410,0,0,0,0,0,0,0,0,412,588,0,582],

"it2":[0,0,0,0,0,0,0,0,0,1330,0,0,0,
7011,0,0,0,0,0,0,0,0,1330,0,0,0,
1330,0,0,0,0,0,0,0,0,0,0,0,0,
0,0,0,0,0,0,0,0,0,0,0,0,0,
0,0,0,0,0,1330,0,0,0,0,0,0,0,
0,0,0,0,0,0,0,0,0,1330,0,0,0,
0,0,0,0,0,0,0,0,0,0,0,0,0],

"sandwave":[1,2,3,4,5,6,7,8,9,10,11,12,13,14,15,16,17,18,19,20,21,22,23,24,25,26,27,28,29,30],
"sandhole1":[[9,4],[10,4],[11,4],[9,3],[10,3],[11,3],[4,2],[6,2],[9,2],[10,2],[11,2]],

"point1": [[4,1],[7,1],[7,5],[2,5],[2,0],[3,0]],
"point2": [[4,1],[7,1],[7,5],[2,5],[2,0],[3,0]],
"point3": [[1,0],[1,6],[8,6],[8,0],[3,0]],
"point4": [[1,0],[1,6],[8,6],[8,0],[3,0]]

}
