{
"row":13,
"col":7,
"isloop":0,
"datas":[2,1,1,1,1,1,1,1,1,2,2,2,2,
2,0,2,2,2,2,2,2,1,1,2,2,2,
2,2,2,2,2,2,2,2,2,1,1,1,2,
2,2,1,1,1,1,1,1,1,1,1,1,2,
2,1,1,2,2,2,2,2,2,2,2,2,2,
2,1,1,1,1,1,1,1,1,1,1,1,2,
2,2,2,2,2,2,2,2,2,2,2,2,2],

"it1":[430,0,0,0,0,0,0,0,0,422,0,434,0,
0,0,434,0,429,0,433,0,0,0,0,0,0,
433,0,0,0,427,427,0,0,423,0,0,0,432,
0,0,0,0,0,0,0,0,0,0,0,0,0,
432,0,0,426,0,429,0,423,426,0,426,0,0,
0,0,0,0,0,0,0,0,0,0,0,0,432,
0,429,0,421,426,0,426,0,421,422,0,423,0],

"it2":[],

"point1": [[11,5],[1,5],[1,4],[2,4],[2,3],[11,3],[11,2],[9,2],[9,1],[8,1],[8,0],[1,0]],
"point2": [[11,5],[1,5],[1,4],[2,4],[2,3],[11,3],[11,2],[9,2],[9,1],[8,1],[8,0],[1,0]]

}
