{
"row":13,
"col":7,
"isloop":0,
"datas":[2,2,1,1,2,2,2,2,2,1,1,2,2,
2,1,1,1,1,2,2,2,1,1,1,1,2,
1,1,2,2,1,1,2,1,1,2,2,1,1,
2,2,2,2,2,1,1,1,2,2,2,2,2,
1,1,2,2,1,1,0,1,1,2,2,1,1,
2,1,1,1,1,2,2,2,1,1,1,1,2,
2,2,1,1,2,2,2,2,2,1,1,2,2],

"it1":[431,423,0,0,0,434,0,432,0,0,0,424,430,
0,0,0,0,0,0,0,0,0,0,0,0,0,
0,0,426,0,0,0,0,0,0,433,0,0,0,
429,0,433,0,425,0,0,0,425,0,0,429,0,
0,0,0,0,0,0,0,0,0,426,0,0,0,
430,0,0,0,0,432,434,0,0,0,0,0,431,
0,424,0,0,0,0,0,0,0,0,0,423,0],

"it2":[0,0,0,0,0,0,0,0,0,0,0,0,0,
3011,0,0,0,0,0,0,0,0,0,0,0,3011,
0,0,0,0,0,0,0,0,0,0,0,0,0,
0,0,0,0,2011,0,0,0,2011,0,0,0,0,
0,0,0,0,0,0,0,0,0,0,0,0,0,
3011,0,0,0,0,0,0,0,0,0,0,0,3011,
0,0,0,0,0,0,0,0,0,0,0,0,0],

"point1": [[0,4],[1,4],[1,5],[2,5],[2,6],[3,6],[3,5],[4,5],[4,4],[5,4],[5,3],[6,3]],
"point2": [[0,2],[1,2],[1,1],[2,1],[2,0],[3,0],[3,1],[4,1],[4,2],[5,2],[5,3],[6,3]],
"point3": [[12,4],[11,4],[11,5],[10,5],[10,6],[9,6],[9,5],[8,5],[8,4],[7,4],[7,3],[6,3]],
"point4": [[12,2],[11,2],[11,1],[10,1],[10,0],[9,0],[9,1],[8,1],[8,2],[7,2],[7,3],[6,3]]

}
