{
"row":13,
"col":7,
"isloop":0,
"datas":[2,2,2,2,2,2,2,2,2,2,2,2,2,
2,2,2,1,1,1,1,1,1,1,2,2,2,
2,2,2,1,2,2,2,2,2,2,2,2,2,
2,2,2,1,1,1,1,1,1,1,2,2,2,
2,2,2,2,2,2,2,2,2,1,2,2,2,
2,2,2,1,1,1,1,1,1,1,2,2,2,
2,2,2,0,2,2,2,2,2,2,2,2,2],

"it1":[421,427,432,426,0,424,429,0,426,0,431,433,0,
426,0,0,0,0,0,0,0,0,0,0,0,0,
429,0,0,0,421,427,426,0,429,0,434,0,424,
432,434,0,0,0,0,0,0,0,0,0,0,431,
0,0,0,428,424,421,422,0,7021,0,430,428,0,
433,0,432,0,0,0,0,0,0,0,0,432,430,
0,0,0,0,429,0,422,0,426,0,421,0,0],

"it2":[],

"point1": [[9,1],[3,1],[3,3],[9,3],[9,5],[3,5]],
"point2": [[9,1],[3,1],[3,3],[9,3],[9,5],[3,5]]

}
