{
"row":13,
"col":7,
"isloop":0,
"datas":[2,2,2,2,2,2,2,2,2,2,2,2,2,
2,2,2,2,1,1,1,2,1,1,1,2,2,
2,2,2,2,1,2,1,2,1,2,0,2,2,
2,2,1,2,1,2,1,1,1,2,2,2,2,
2,2,1,2,1,2,2,2,1,2,2,2,2,
2,2,1,1,1,2,2,2,1,1,1,1,2,
2,2,2,2,2,2,2,2,2,2,2,2,2],

"it1":[421,429,0,426,0,422,0,428,426,0,421,434,0,
432,424,434,0,0,0,0,432,0,0,0,0,0,
0,432,0,0,0,430,0,0,0,431,0,426,0,
424,0,0,432,0,0,0,0,0,0,0,428,432,
429,0,0,0,0,433,0,431,0,421,422,0,0,
422,0,0,0,0,0,0,0,0,0,0,0,432,
424,428,428,422,0,421,422,0,423,426,0,427,0],

"it2":[],

"point1": [[2,3],[2,5],[4,5],[4,1],[6,1],[6,3],[8,3],[8,1],[10,1]],
"point2": [[2,3],[2,5],[4,5],[4,1],[6,1],[6,3],[8,3],[8,1],[10,1]],
"point3": [[11,5],[8,5],[8,1],[10,1]],
"point4": [[11,5],[8,5],[8,1],[10,1]]

}
