{
"row":13,
"col":7,
"isloop":0,
"datas":[2,2,2,2,2,2,2,2,2,2,2,2,2,
2,2,2,2,2,2,2,2,1,1,1,2,2,
2,2,1,1,1,1,2,2,1,2,1,2,2,
2,2,1,2,2,1,2,2,1,2,1,2,2,
1,1,1,2,2,1,1,1,1,2,1,1,1,
0,1,1,2,2,2,2,2,2,2,2,2,2,
2,2,2,2,2,2,2,2,2,2,2,2,2],

"it1":[434,0,426,0,421,426,0,426,0,429,0,401,403,
0,0,427,428,426,0,423,421,0,0,0,434,0,
421,431,0,0,0,0,434,0,0,425,0,0,0,
0,0,0,426,0,0,0,0,0,430,0,426,0,
0,0,0,434,0,0,0,0,0,0,0,0,0,
0,0,0,0,0,432,428,426,0,426,0,434,0,
421,423,428,429,0,0,429,0,421,429,0,0,0],

"it2":[0,0,0,0,0,0,0,0,0,0,0,0,0,
0,0,0,0,0,0,0,0,0,0,0,0,0,
0,0,0,0,0,0,0,0,0,2021,0,0,0,
0,0,0,0,0,0,0,0,0,0,0,0,0,
0,0,0,0,0,0,0,0,0,0,0,0,0,
0,0,0,0,0,0,0,0,0,0,0,0,0,
0,0,0,0,0,0,0,0,0,0,0,0,0],

"point1": [[12,4],[10,4],[10,1],[8,1],[8,4],[5,4],[5,2],[2,2],[2,5],[1,5],[1,4],[0,4]],
"point2": [[12,4],[10,4],[10,1],[8,1],[8,4],[5,4],[5,2],[2,2],[2,5],[1,5],[1,4],[0,4]],
"point3": [[12,4],[10,4],[10,1],[8,1],[8,4],[5,4],[5,2],[2,2],[2,5],[1,5],[1,4],[0,4]]

}
