{
"row":13,
"col":7,
"isloop":0,
"datas":[2,2,2,2,2,1,1,1,2,2,2,2,2,
2,2,2,2,2,1,2,1,2,2,2,2,2,
2,2,1,1,1,1,2,1,1,1,1,2,2,
2,2,0,2,2,2,2,2,2,2,1,2,2,
2,2,1,1,1,1,2,1,1,1,1,2,2,
2,2,2,2,2,1,2,1,2,2,2,2,2,
2,2,2,2,2,1,1,1,2,2,2,2,2],

"it1":[426,0,0,434,0,0,0,0,434,0,430,426,0,
433,0,0,0,0,0,423,0,0,0,0,421,401,
0,0,0,0,0,0,425,0,0,0,0,432,431,
431,421,0,423,424,425,403,425,429,0,0,0,0,
0,431,0,0,0,0,425,0,0,0,0,433,0,
401,0,430,433,0,0,423,0,434,0,431,0,0,
426,0,0,0,0,0,0,0,0,0,0,426,0],

"it2":[0,0,0,0,0,0,0,0,0,0,0,0,0,
0,0,0,0,0,0,0,0,0,0,0,0,0,
0,0,0,0,0,0,4021,0,0,0,0,0,0,
0,0,0,0,0,4021,0,4021,0,0,0,0,0,
0,0,0,0,0,0,4021,0,0,0,0,0,0,
0,0,0,0,0,0,0,0,0,0,0,0,0,
0,0,0,0,0,0,0,0,0,0,0,0,0],

"point1": [[2,4],[5,4],[5,6],[7,6],[7,4],[10,4],[10,2],[7,2],[7,0],[5,0],[5,2],[2,2]],
"point2": [[2,4],[5,4],[5,6],[7,6],[7,4],[10,4],[10,2],[7,2],[7,0],[5,0],[5,2],[2,2]],
"point3": [[2,4],[5,4],[5,6],[7,6],[7,4],[10,4],[10,2],[7,2],[7,0],[5,0],[5,2],[2,2]]

}
