{
"row":13,
"col":7,
"isloop":0,
"datas":[2,2,2,2,2,2,2,2,2,2,2,2,2,
2,2,2,2,1,1,1,1,1,2,2,2,2,
2,2,2,2,1,2,2,2,1,2,2,2,2,
2,2,2,2,1,1,1,1,1,2,2,2,2,
2,2,2,2,1,2,2,0,1,2,2,2,2,
2,2,2,2,1,1,1,1,1,2,2,2,2,
2,2,2,2,2,2,2,2,2,2,2,2,2],

"it1":[434,0,421,422,0,427,421,428,422,0,421,434,0,
0,0,434,0,0,0,0,0,0,434,0,0,0,
421,424,0,0,0,429,0,401,0,0,0,424,421,
423,421,423,421,0,0,0,0,0,421,423,421,423,
421,424,434,0,0,403,0,0,0,434,0,424,421,
434,0,0,0,0,0,0,0,0,0,0,434,0,
0,0,421,422,0,428,421,427,422,0,421,0,0],

"it2":[0,0,0,6021,0,0,0,0,0,6021,0,0,0,
0,0,0,0,0,0,0,0,0,0,0,0,0,
0,0,0,0,0,0,0,0,0,0,0,0,0,
0,0,0,0,0,0,0,0,0,0,0,0,0,
0,0,0,0,0,0,0,0,0,0,0,0,0,
0,0,0,0,0,0,0,0,0,0,0,0,0,
0,0,0,6021,0,0,0,0,0,6021,0,0,0],

"point1": [[4,2],[4,1],[8,1],[8,5],[4,5],[4,3],[7,3]],
"point2": [[4,2],[4,1],[8,1],[8,5],[4,5],[4,3],[7,3]],
"point3": [[8,5],[4,5],[4,3],[7,3]],
"point4": [[8,5],[4,5],[4,3],[7,3]]

}
