{
"row":13,
"col":7,
"isloop":0,
"datas":[2,2,2,2,2,2,2,2,2,2,2,2,2,
2,1,1,1,1,1,1,1,1,1,1,1,1,
2,1,2,2,2,2,1,2,2,2,2,1,0,
2,1,2,2,2,2,1,2,2,2,2,1,2,
2,1,2,2,2,2,1,2,2,2,2,1,2,
2,1,1,1,1,1,1,1,1,1,1,1,2,
2,2,2,2,2,2,2,2,2,2,2,2,2],

"it1":[0,428,426,0,427,426,0,428,426,0,427,426,0,
431,0,0,0,0,0,0,0,0,0,0,0,0,
0,0,426,0,425,423,0,432,429,0,423,0,0,
428,0,423,422,0,431,0,0,401,422,0,0,423,
430,0,401,429,0,0,0,421,426,0,425,0,430,
0,0,0,0,0,0,0,0,0,0,0,0,0,
426,0,427,426,0,428,426,0,427,426,0,428,0],

"it2":[0,0,0,0,0,0,0,0,0,0,0,0,0,
0,0,0,0,0,0,0,0,0,0,0,0,0,
0,0,0,0,5021,0,0,0,0,0,0,0,0,
0,0,0,0,0,0,0,0,0,0,0,0,0,
0,0,0,0,0,0,0,0,0,0,5021,0,0,
0,0,0,0,0,0,0,0,0,0,0,0,0,
0,0,0,0,0,0,0,0,0,0,0,0,0],

"point1": [[1,5],[1,1],[6,1],[6,5],[11,5],[11,1],[12,1]],
"point2": [[1,5],[6,5],[6,1],[12,1]],
"point3": [[1,5],[11,5],[11,1],[12,1]],
"point4": [[1,5],[1,1],[12,1]]

}
