{
"row":13,
"col":7,
"isloop":0,
"iswood":1,
"datas":[4,2,2,2,2,2,2,2,2,2,2,2,4,
2,2,1,1,1,1,1,1,1,1,1,2,2,
2,2,1,4,4,2,2,4,4,2,2,2,2,
2,2,1,1,1,1,1,1,1,1,1,2,2,
2,2,2,2,4,2,0,2,4,2,1,2,2,
2,2,1,1,1,1,1,1,1,1,1,2,2,
4,2,2,2,2,2,2,2,2,2,2,2,4],

"it1":[0,620,626,0,628,0,620,626,0,628,0,620,0,
629,0,0,0,0,0,0,0,0,0,0,630,0,
0,0,0,0,0,628,0,0,0,622,0,0,0,
628,0,0,0,0,0,0,0,0,0,0,628,0,
630,0,626,0,0,622,0,622,0,620,0,629,0,
0,0,0,0,0,0,0,0,0,0,0,0,0,
0,620,626,0,628,0,620,626,0,628,0,620,0],

"it2":[],

"point1": [[2,5],[10,5],[10,3],[6,3]],
"point2": [[2,5],[10,5],[10,3],[6,3]],
"point3": [[10,1],[2,1],[2,3],[6,3]],
"point4": [[10,1],[2,1],[2,3],[6,3]]

}
