{
"row":13,
"col":7,
"isloop":0,
"datas":[2,2,2,2,2,2,2,2,2,2,2,2,2,
2,1,1,1,1,1,1,1,2,2,2,2,2,
2,2,2,2,2,2,2,1,2,2,2,2,2,
2,2,2,2,2,2,2,1,1,1,1,1,1,
2,2,2,2,2,2,2,1,2,2,2,2,0,
2,1,1,1,1,1,1,1,2,2,2,2,2,
2,2,2,2,2,2,2,2,2,2,2,2,2],

"it1":[426,0,424,401,426,0,426,0,426,0,432,424,432,
421,0,0,0,0,0,0,0,432,424,0,432,0,
430,434,0,401,429,0,421,0,0,426,0,0,0,
0,0,0,430,427,434,0,0,0,0,0,0,0,
401,426,0,0,421,0,0,0,432,424,426,0,0,
432,0,0,0,0,0,0,0,0,421,424,422,0,
0,426,0,426,0,401,426,0,424,422,0,422,0],

"it2":[0,0,0,0,0,0,0,0,0,0,0,0,0,
6021,0,0,0,0,0,0,0,0,0,0,0,0,
0,0,0,0,0,0,1021,0,0,0,0,0,0,
0,0,0,0,0,0,0,0,0,0,0,0,0,
0,0,0,0,0,0,0,0,0,0,0,0,0,
6021,0,0,0,0,0,0,0,0,0,0,0,0,
0,0,0,0,0,0,0,0,0,0,0,0,0],

"point1": [[1,5],[7,5],[7,3],[12,3]],
"point2": [[1,1],[7,1],[7,3],[12,3]],
"point3": [[1,5],[7,5],[7,3],[12,3]],
"point4": [[1,1],[7,1],[7,3],[12,3]]

}
