{
"row":13,
"col":7,
"isloop":0,
"datas":[2,2,2,2,1,1,1,1,1,1,1,1,2,
2,2,2,2,1,2,2,2,2,2,2,1,1,
2,2,2,2,1,2,2,2,2,2,2,2,1,
2,2,2,2,1,1,1,1,1,1,1,2,1,
2,2,2,2,2,2,2,2,2,2,1,2,1,
2,1,1,1,1,1,1,1,1,1,1,2,1,
2,2,2,2,2,2,2,2,2,2,2,2,0],

"it1":[423,434,0,423,0,0,0,0,0,0,0,0,423,
427,0,0,423,0,433,0,430,434,0,432,0,0,
403,429,0,423,0,0,0,0,0,0,0,423,0,
432,423,423,423,0,0,0,0,0,0,0,428,0,
0,429,0,428,422,0,0,429,0,428,0,423,0,
427,0,0,0,0,0,0,0,0,0,0,431,0,
421,429,0,427,426,0,421,426,0,427,421,0,0],

"it2":[],

"point1": [[1,5],[10,5],[10,3],[4,3],[4,0],[11,0],[11,1],[12,1],[12,5]],
"point2": [[1,5],[10,5],[10,3],[4,3],[4,0],[11,0],[11,1],[12,1],[12,5]]

}
