{
"row":13,
"col":7,
"isloop":1,
"datas":[2,2,2,2,2,2,2,2,2,2,2,2,2,
2,2,1,1,1,1,2,1,1,1,1,2,2,
2,2,1,2,2,1,1,1,2,2,1,2,2,
2,2,1,2,2,2,2,2,2,2,1,2,2,
2,2,1,2,2,1,1,1,2,2,1,2,2,
2,2,1,1,1,1,2,1,1,1,1,2,2,
2,2,2,2,2,2,2,2,2,2,2,2,2],

"it1":[429,0,421,424,426,0,430,429,0,427,401,429,0,
434,0,0,0,0,0,0,0,0,0,0,433,0,
0,0,0,422,0,0,0,0,426,0,0,0,0,
422,0,0,428,429,0,0,429,0,428,0,422,0,
433,0,0,426,0,0,0,0,422,0,0,434,0,
0,0,0,0,0,0,430,0,0,0,0,0,0,
422,0,421,424,429,0,0,426,0,424,401,429,0],

"it2":[],

"point1":[[5,4],[5,5],[2,5],[2,1],[5,1],[5,2],[7,2],[7,1],[10,1],[10,5],[7,5],[7,4],[5,4]]

}
