{
"row":13,
"col":7,
"isloop":0,
"datas":[2,2,2,2,2,2,2,2,2,2,2,2,2,
2,2,2,2,2,2,1,1,1,1,1,2,2,
2,2,2,2,2,2,1,2,2,2,0,2,2,
2,2,1,1,1,1,1,2,2,2,2,2,2,
2,2,1,2,2,1,1,1,2,2,2,2,2,
2,2,1,2,2,1,2,1,2,2,2,2,2,
2,2,2,2,2,1,1,1,2,2,2,2,2],

"it1":[430,426,0,427,429,0,423,429,0,427,426,0,423,
0,421,427,423,433,0,0,0,0,0,0,423,423,
423,432,426,0,0,0,0,427,433,0,0,433,0,
430,0,0,0,0,0,0,423,0,0,0,0,0,
0,430,0,434,0,0,0,0,433,0,430,430,423,
423,0,0,0,0,0,423,0,0,0,0,0,423,
421,426,0,426,0,0,0,0,401,428,426,0,423],

"it2":[0,0,0,0,0,0,0,0,0,0,0,0,0,
0,0,0,0,0,0,0,0,0,0,0,0,0,
0,0,0,0,0,0,0,0,0,0,0,0,0,
0,0,0,0,0,0,0,0,0,0,0,0,0,
0,0,0,0,0,0,0,0,0,0,0,0,0,
0,0,0,0,0,0,0,0,0,0,0,0,0,
0,0,0,0,0,0,0,0,0,0,0,0,0],

"point1": [[2,5],[2,3],[5,3],[5,6],[7,6],[7,4],[6,4],[6,1],[10,1]],
"point2": [[2,5],[2,3],[5,3],[5,6],[7,6],[7,4],[6,4],[6,1],[10,1]]

}
