{
"row":13,
"col":7,
"isloop":0,
"destroyed1":[[9,4],[8,4]],
"destroyed2":[[9,4],[8,4]],
"datas":[2,2,2,2,2,2,2,2,2,2,2,2,2,
2,2,1,1,1,1,1,1,1,1,1,2,2,
2,2,1,2,2,2,2,2,2,2,0,2,2,
2,2,1,2,2,2,2,2,2,2,2,2,2,
2,2,1,1,1,1,1,1,1,2,2,2,2,
2,2,2,2,2,2,2,2,2,2,2,2,2,
2,2,2,2,2,2,2,2,2,2,2,2,2],

"it1":[430,429,0,428,429,0,429,0,427,426,0,428,421,
0,430,0,0,0,0,0,0,0,0,0,430,421,
424,0,0,434,0,424,429,0,430,432,0,0,430,
432,0,0,0,0,429,0,428,0,0,421,430,0,
0,432,0,0,0,0,0,0,0,400,0,0,430,
430,0,421,426,0,426,0,422,0,0,0,423,0,
0,427,426,0,427,426,0,427,422,0,422,0,421],

"it2":[],

"point1": [[8,4],[2,4],[2,1],[10,1]],
"point2": [[8,4],[2,4],[2,1],[10,1]]

}
