{
"row":13,
"col":7,
"isloop":1,
"datas":[2,2,2,2,2,2,2,2,1,1,1,2,2,
2,2,2,2,1,1,1,2,1,2,1,1,2,
2,2,2,2,1,2,1,2,1,2,2,1,2,
2,1,1,1,1,1,1,1,1,1,1,1,2,
2,1,2,2,1,2,1,2,1,2,2,2,2,
2,1,1,2,1,2,1,1,1,2,2,2,2,
2,2,1,1,1,2,2,2,2,2,2,2,2],

"it1":[433,0,423,426,0,429,0,431,0,0,0,401,428,
0,0,434,0,0,0,0,0,0,432,0,0,432,
430,423,0,0,0,423,0,423,0,0,423,0,0,
0,0,0,0,0,0,0,0,0,0,0,0,430,
432,0,423,432,0,423,0,0,0,434,0,423,0,
0,0,0,0,0,431,0,0,0,0,0,433,0,
428,401,0,0,0,0,429,0,426,0,423,0,0],

"it2":[],

"point1": [[2,6],[2,5],[1,5],[1,3],[11,3],[11,1],[10,1],[10,0],[8,0],[8,5],[6,5],[6,1],[4,1],[4,6],[2,6]],
"point2": [[2,6],[2,5],[1,5],[1,3],[11,3],[11,1],[10,1],[10,0],[8,0],[8,5],[6,5],[6,1],[4,1],[4,6],[2,6]]

}
