{
"row":13,
"col":7,
"isloop":0,
"datas":[2,2,2,2,2,2,2,2,2,2,2,2,2,
1,1,1,1,1,2,2,1,1,1,1,1,2,
0,2,2,2,1,2,2,1,2,2,2,1,2,
2,2,2,2,1,2,2,1,2,2,2,1,2,
2,1,1,1,1,1,1,1,1,1,1,1,2,
2,2,2,2,1,2,2,1,2,2,2,2,2,
2,2,2,2,1,1,1,1,2,2,2,2,2],

"it1":[429,0,426,0,0,434,0,426,0,423,426,0,423,
0,0,0,0,0,0,0,0,0,0,0,0,431,
0,432,434,0,0,433,0,0,421,434,0,0,0,
432,0,0,0,0,0,0,0,423,0,0,0,432,
0,0,0,0,0,0,0,0,0,0,0,0,0,
433,0,433,0,0,429,0,0,430,433,0,433,0,
0,0,0,0,0,0,0,0,0,0,0,0,0],

"it2":[],

"point1": [[1,4],[11,4],[11,1],[7,1],[7,6],[4,6],[4,1],[0,1]],
"point2": [[1,4],[11,4],[11,1],[7,1],[7,6],[4,6],[4,1],[0,1]]

}
