{
"row":13,
"col":7,
"isloop":0,
"iswood":1,
"datas":[2,1,1,1,1,1,1,1,1,1,1,1,1,
2,1,2,2,2,2,2,4,4,1,2,2,0,
2,1,1,2,2,4,4,4,4,1,4,2,2,
4,4,1,4,4,2,4,1,1,1,2,2,2,
4,4,1,2,2,2,4,1,4,4,2,2,2,
2,4,1,2,2,2,2,1,4,4,2,2,2,
2,2,1,1,1,1,2,1,1,1,2,2,2],

"it1":[410,0,0,0,0,0,0,0,0,0,0,0,0,
625,0,401,629,0,626,0,0,0,0,412,0,0,
0,0,0,0,0,0,0,0,0,0,0,628,0,
0,0,0,0,0,624,0,0,0,0,630,0,623,
0,0,0,406,0,0,0,0,0,0,0,0,0,
623,0,0,0,0,628,0,0,0,0,624,629,0,
0,622,0,0,0,0,620,0,0,0,0,0,0],

"it2":[3031,0,0,0,0,0,0,0,0,0,0,0,0,
0,0,0,0,0,0,0,0,0,0,0,0,0,
0,0,0,0,0,0,0,0,0,0,0,0,0,
0,0,0,0,0,0,0,0,0,0,3021,0,0,
0,0,0,0,0,0,0,0,0,0,0,0,0,
0,0,0,0,0,3011,0,0,0,0,0,0,0,
0,0,0,0,0,0,0,0,0,0,0,0,0],

"point1": [[5,6],[2,6],[2,2],[1,2],[1,0],[12,0]],
"point2": [[5,6],[2,6],[2,2],[1,2],[1,0],[12,0]],
"point3": [[5,6],[2,6],[2,2],[1,2],[1,0],[12,0]],
"point4": [[9,6],[7,6],[7,3],[9,3],[9,0],[12,0]],
"point5": [[9,6],[7,6],[7,3],[9,3],[9,0],[12,0]]

}
