{
"row":13,
"col":7,
"isloop":0,
"datas":[1,1,1,1,1,1,1,1,1,1,1,1,1,
1,2,2,2,2,2,2,2,2,2,2,2,1,
1,2,2,1,1,1,1,1,1,1,2,2,1,
1,2,2,1,2,2,2,2,2,2,2,2,1,
1,2,2,1,2,2,2,2,2,2,2,2,1,
1,2,2,1,1,1,1,1,1,1,1,1,1,
0,2,2,2,2,2,2,2,2,2,2,2,2],

"it1":[0,0,0,0,0,0,0,0,0,0,0,0,0,
0,432,421,423,429,0,424,429,0,423,424,432,0,
0,0,0,0,0,0,0,0,0,0,0,0,0,
0,423,423,0,426,0,434,0,424,432,433,0,0,
0,433,0,0,423,424,0,0,423,0,0,0,0,
0,0,0,0,0,0,0,0,0,0,0,0,0,
0,429,0,421,429,0,421,429,0,421,429,0,421],

"it2":[],

"point1": [[9,2],[3,2],[3,5],[12,5],[12,0],[0,0],[0,5]],
"point2": [[9,2],[3,2],[3,5],[12,5],[12,0],[0,0],[0,5]],

"jingjiId":435,
"jingjiCount":[3,3]
}
