{
"row":13,
"col":7,
"isloop":0,
"datas":[1,1,1,1,1,1,2,2,2,2,2,2,2,
1,2,2,2,2,1,2,2,1,1,1,1,2,
1,2,2,2,2,1,1,1,1,2,2,1,2,
2,2,2,2,2,2,2,2,2,2,2,1,1,
1,2,2,2,2,1,1,1,1,2,2,1,0,
1,2,2,2,2,1,2,2,1,1,1,1,2,
1,1,1,1,1,1,2,2,2,2,2,2,2],

"it1":[0,0,0,0,0,0,425,425,429,0,426,0,431,
0,431,434,0,430,0,425,425,0,0,0,0,0,
0,0,0,0,0,0,0,0,0,427,0,0,421,
423,426,0,423,426,0,423,421,429,0,0,0,0,
0,430,434,0,431,0,0,0,0,427,0,0,0,
0,0,0,0,0,0,425,425,0,0,0,0,431,
0,0,0,0,0,0,425,425,429,0,426,0,0],

"it2":[0,0,0,0,0,0,7011,7011,0,0,0,0,0,
0,0,0,0,0,0,7011,7011,0,0,0,0,0,
0,0,0,0,0,0,0,0,0,0,0,0,0,
0,0,0,0,0,0,0,0,0,0,0,0,0,
0,0,0,0,0,0,0,0,0,0,0,0,0,
0,0,0,0,0,0,7011,7011,0,0,0,0,0,
0,0,0,0,0,0,7011,7011,0,0,0,0,0],

"point1": [[0,4],[0,6],[5,6],[5,4],[8,4],[8,5],[11,5],[11,3],[12,3]],
"point2": [[0,4],[0,6],[5,6],[5,4],[8,4],[8,5],[11,5],[11,3],[12,3]],
"point3": [[0,2],[0,0],[5,0],[5,2],[8,2],[8,1],[11,1],[11,3],[12,3]],
"point4": [[0,2],[0,0],[5,0],[5,2],[8,2],[8,1],[11,1],[11,3],[12,3]],

"jingjiId":435,
"jingjiCount":[0,5]
}
