{
"row":13,
"col":7,
"isloop":0,
"datas":[2,2,2,2,2,2,2,2,2,2,2,2,2,
2,1,2,2,2,2,2,2,2,2,2,2,2,
2,1,2,2,2,2,2,2,2,2,2,2,2,
2,1,1,1,1,1,1,1,1,1,1,1,2,
2,2,2,2,2,2,2,2,2,2,2,0,2,
2,2,2,2,2,2,2,2,2,2,2,2,2,
2,2,2,2,2,2,2,2,2,2,2,2,2],

"it1":[431,429,0,432,427,426,0,423,429,0,427,426,0,
0,0,427,0,434,0,431,433,0,421,426,0,428,
430,0,426,0,0,0,0,0,0,426,0,0,0,
0,0,0,0,0,0,0,0,0,0,0,0,432,
432,403,434,0,429,0,432,429,0,426,0,0,0,
0,403,0,0,433,0,0,434,0,429,0,433,0,
426,0,429,0,0,0,423,0,0,429,0,0,0],

"it2":[],

"point1": [[1,1],[1,3],[11,3]],
"point2": [[1,1],[1,3],[11,3]],

"jingjiId":435,
"jingjiCount":[0,5]
}
