{
"row":13,
"col":7,
"isloop":0,
"datas":[2,2,2,2,2,2,2,2,2,2,2,2,2,
2,1,1,1,1,1,2,1,1,1,1,1,2,
2,1,2,2,2,1,2,1,2,2,2,1,2,
2,1,2,2,2,1,1,1,2,2,2,1,2,
2,1,2,2,2,2,2,2,2,2,2,1,2,
2,1,1,1,1,1,1,1,1,1,1,1,2,
2,2,2,2,2,2,2,2,2,2,2,0,2],

"it1":[426,0,429,0,422,0,430,429,0,423,426,0,430,
430,0,0,0,0,0,0,0,0,0,0,0,0,
0,0,430,434,0,0,423,0,426,0,432,0,432,
424,0,0,0,0,0,0,0,428,0,0,0,0,
432,0,424,422,0,426,0,429,0,426,0,0,424,
0,0,0,0,0,0,0,0,0,0,0,0,430,
426,0,421,429,0,423,429,0,421,429,0,0,0],

"it2":[0,0,0,0,0,0,0,0,0,0,0,0,0,
0,0,0,0,0,0,0,0,0,0,0,0,0,
0,0,0,0,0,0,2021,0,0,0,0,0,0,
0,0,0,0,0,0,0,0,0,0,0,0,0,
0,0,0,0,0,0,0,0,0,0,0,0,0,
3031,0,0,0,0,0,0,0,0,0,0,0,0,
0,0,0,0,0,0,0,0,0,0,0,0,0],

"point1": [[1,5],[1,1],[5,1],[5,3],[7,3],[7,1],[11,1],[11,5]],
"point2": [[1,5],[1,1],[5,1],[5,3],[7,3],[7,1],[11,1],[11,5]],
"point3": [[1,5],[11,5]],
"point4": [[1,5],[11,5]],

"jingjiId":435,
"jingjiCount":[0,5]
}
