{
"row":13,
"col":7,
"isloop":0,
"datas":[2,2,2,2,2,2,2,2,2,2,2,2,2,
2,2,2,2,2,2,2,2,2,2,2,2,2,
2,2,2,2,2,1,1,1,1,1,1,2,2,
2,2,2,2,2,0,2,2,2,2,1,2,2,
2,2,1,1,1,1,1,1,1,1,1,2,2,
2,2,2,2,2,2,2,2,2,2,2,2,2,
2,2,2,2,2,2,2,2,2,2,2,2,2],

"it1":[423,433,0,426,0,432,0,432,426,0,434,0,423,
432,0,0,429,0,0,423,0,429,0,0,0,0,
0,432,430,427,423,0,0,0,0,0,0,429,0,
423,0,0,423,427,0,423,423,425,423,0,0,423,
429,0,0,0,0,0,0,0,0,0,0,429,0,
403,434,0,429,0,432,423,432,429,0,433,0,0,
423,0,0,426,0,0,0,0,426,0,0,0,423],

"it2":[0,0,0,0,0,0,0,0,0,0,0,0,0,
0,0,0,0,0,0,0,0,0,0,0,0,0,
0,0,0,0,0,0,0,0,0,0,0,0,0,
0,0,0,0,0,0,0,0,4011,0,0,0,0,
0,0,0,0,0,0,0,0,0,0,0,0,0,
0,6011,6011,0,0,0,0,0,0,0,6011,6011,0,
0,0,0,0,0,0,0,0,0,0,0,0,0],

"point1": [[2,4],[10,4],[10,2],[5,2]],
"point2": [[2,4],[10,4],[10,2],[5,2]],

"jingjiId":435,
"jingjiCount":[0,5]
}
