{
"row":13,
"col":7,
"isloop":0,
"datas":[1,1,1,1,1,1,2,2,2,1,1,2,2,
1,2,2,2,2,1,2,2,2,0,1,2,2,
1,2,2,2,2,1,2,2,2,2,1,2,2,
1,1,2,2,2,1,1,1,1,1,1,2,2,
2,1,1,1,2,2,2,2,2,2,2,2,2,
2,2,2,2,2,2,2,2,2,2,2,2,2,
2,2,2,2,2,2,2,2,2,2,2,2,2],

"it1":[0,0,0,0,0,0,401,475,475,0,0,471,473,
0,477,481,0,475,0,401,475,475,0,0,471,473,
0,0,482,0,477,0,471,471,481,0,0,480,0,
0,0,0,0,0,0,0,0,0,0,0,478,471,
0,0,0,0,482,0,478,482,0,475,477,0,471,
476,471,471,475,0,0,0,0,0,475,0,478,475,
0,471,471,475,475,475,480,0,475,475,475,0,0],

"it2":[0,0,0,0,0,0,0,0,1021,0,0,0,0,
0,0,0,0,0,0,0,0,1021,0,0,0,0,
0,0,0,0,0,0,0,0,0,0,0,0,0,
0,0,0,0,0,0,0,0,0,0,0,0,0,
0,0,0,0,0,0,0,0,0,1021,0,0,0,
0,0,1021,0,0,0,0,0,0,0,0,0,0,
0,0,0,0,0,0,0,0,0,0,0,0,0],

"point1": [[3,4],[1,4],[1,3],[0,3],[0,0],[5,0],[5,3],[10,3],[10,0],[9,0]],
"point2": [[3,4],[1,4],[1,3],[0,3],[0,0],[5,0],[5,3],[10,3],[10,0],[9,0]],
"point3": [[3,4],[1,4],[1,3],[0,3],[0,0],[5,0],[5,3],[10,3],[10,0],[9,0]],
"point4": [[3,4],[1,4],[1,3],[0,3],[0,0],[5,0],[5,3],[10,3],[10,0],[9,0]],

"snow":25,
"freeze":50,
"freezeTime":5000,
"freezeDy":100
}
