{
"row":13,
"col":7,
"isloop":0,
"datas":[2,1,1,1,1,1,1,1,1,1,1,1,2,
2,1,2,2,0,1,2,2,2,2,2,1,2,
2,1,2,2,2,1,2,2,2,2,2,1,2,
2,1,2,2,2,1,2,1,1,1,1,1,2,
2,1,2,2,2,1,2,1,2,2,2,2,2,
2,1,2,2,2,1,2,1,2,2,2,2,2,
2,1,1,1,1,1,2,1,1,1,1,1,2],

"it1":[478,0,0,0,0,0,0,0,0,0,0,0,425,
0,0,478,473,0,0,473,482,0,406,0,0,472,
475,0,0,483,0,0,478,0,0,0,0,0,0,
475,0,475,0,0,0,0,0,0,0,0,0,473,
0,0,477,483,0,0,475,0,483,0,483,0,475,
477,0,0,0,0,0,475,0,0,0,0,0,472,
0,0,0,0,0,0,0,0,0,0,0,0,425],

"it2":[0,0,0,0,0,0,0,0,0,0,0,0,6021,
0,0,0,0,0,0,0,0,403,0,0,0,0,
0,0,0,0,0,0,0,0,0,0,0,0,0,
0,0,0,0,0,0,0,0,0,0,0,0,0,
0,0,0,0,0,0,0,0,0,0,0,0,0,
0,0,0,0,0,0,0,0,0,0,0,0,0,
0,0,0,0,0,0,0,0,0,0,0,0,6021],

"point1": [[11,6],[7,6],[7,3],[11,3],[11,0],[5,0],[5,6],[1,6],[1,0],[4,0]],
"point2": [[11,6],[7,6],[7,3],[11,3],[11,0],[5,0],[5,6],[1,6],[1,0],[4,0]],

"snow":25,
"freeze":50,
"freezeTime":5000,
"freezeDy":100
}
