{
"row":13,
"col":7,
"isloop":0,
"datas":[2,2,2,2,2,2,2,2,2,1,1,1,1,
2,1,1,1,2,2,2,2,2,1,2,2,1,
2,1,2,1,2,2,2,2,2,1,2,2,1,
2,1,2,1,1,1,1,1,1,1,2,2,1,
2,1,2,1,2,2,2,2,2,1,2,2,1,
2,1,1,1,2,2,2,2,2,1,2,2,1,
2,2,2,2,2,2,2,2,2,1,1,1,1],

"it1":[480,0,471,471,471,482,0,482,0,0,0,0,0,
477,0,0,0,473,0,0,0,0,0,472,475,0,
0,0,475,0,471,0,0,473,475,0,472,401,0,
0,0,473,0,0,0,0,0,0,0,472,401,0,
477,0,475,0,471,0,0,474,475,0,472,401,0,
0,0,0,0,473,482,0,483,0,0,472,471,0,
480,0,471,471,471,0,0,0,0,0,0,0,0],

"it2":[0,0,0,0,0,0,0,0,0,0,0,0,0,
0,0,0,0,0,0,0,0,0,0,0,0,0,
0,0,1021,0,0,0,0,0,1021,0,0,0,0,
0,0,0,0,0,0,0,0,0,0,0,0,0,
0,0,1021,0,0,0,0,0,1021,0,0,0,0,
0,0,0,0,0,0,0,0,0,0,0,0,0,
0,0,0,0,0,0,0,0,0,0,0,0,0],

"point1": [[1,3],[1,5],[3,5],[3,3],[9,3],[9,0],[12,0],[12,3]],
"point2": [[1,3],[1,1],[3,1],[3,3],[9,3],[9,6],[12,6],[12,3]],
"point3": [[1,3],[1,5],[3,5],[3,3],[9,3],[9,0],[12,0],[12,3]],
"point4": [[1,3],[1,1],[3,1],[3,3],[9,3],[9,6],[12,6],[12,3]],

"snow":25,
"freeze":50,
"freezeTime":5000,
"freezeDy":100
}
