{
"row":13,
"col":7,
"isloop":0,
"datas":[2,2,2,1,1,1,1,1,2,2,2,2,2,
2,2,2,1,2,2,2,0,2,2,2,2,2,
1,1,1,1,2,2,2,2,2,2,2,2,2,
1,2,2,2,2,2,2,2,2,2,2,2,2,
1,1,1,1,2,2,2,2,2,2,2,2,2,
2,2,2,1,2,2,2,2,2,2,2,2,2,
1,1,1,1,2,2,2,2,2,2,2,2,2],

"it1":[471,473,425,0,0,0,0,0,425,475,478,475,477,
471,473,401,0,475,481,0,0,401,475,0,472,0,
0,0,0,0,476,401,475,475,475,475,475,472,471,
0,0,480,0,0,479,0,425,473,471,425,471,471,
0,0,0,0,482,0,473,481,0,471,479,0,471,
0,481,0,0,0,0,472,480,0,471,479,0,471,
0,0,0,0,473,472,401,471,425,471,1011,473,471],

"it2":[0,0,2023,0,0,0,0,0,6021,0,0,0,0,
0,0,0,0,0,0,0,0,0,0,0,0,0,
0,0,0,0,0,0,0,0,0,0,0,0,0,
0,0,0,0,0,0,0,1021,0,0,1021,0,0,
0,0,0,0,0,0,0,0,0,0,0,0,0,
0,0,0,0,0,0,0,0,0,0,0,0,0,
0,0,0,0,0,0,0,0,1021,0,0,0,0],

"point1": [[0,6],[3,6],[3,4],[0,4],[0,2],[3,2],[3,0],[7,0]],
"point2": [[0,6],[3,6],[3,4],[0,4],[0,2],[3,2],[3,0],[7,0]],

"snow":25,
"freeze":50,
"freezeTime":5000,
"freezeDy":100
}
