{
"row":13,
"col":7,
"isloop":0,
"iswood":1,
"datas":[1,3,3,3,3,3,3,3,3,3,3,3,1,
2,4,4,4,2,4,4,4,2,4,2,3,0,
2,2,2,2,2,2,2,2,2,2,2,2,3,
2,2,2,2,2,2,2,2,2,2,2,2,2,
2,4,2,2,2,4,2,2,2,4,2,2,4,
2,4,2,2,2,4,2,2,2,4,2,2,4,
2,2,2,2,2,2,2,2,2,2,2,4,2],

"it1":[0,0,0,0,0,0,0,0,0,0,0,0,0,
621,0,0,0,621,0,0,0,621,0,401,0,0,
627,0,626,0,624,626,0,622,621,620,626,0,0,
625,621,630,0,0,627,0,621,627,0,621,624,622,
0,0,0,0,401,0,630,0,622,0,620,0,0,
625,0,412,629,0,0,0,0,623,0,628,0,0,
0,627,0,0,0,620,620,620,0,628,0,0,620],

"it2":[],

"point1": [[0,0],[12,0]],
"point2": [[0,0],[12,0]],
"point3": [[0,0],[12,0]],
"point4": [[0,0],[12,0]]

}
