{
"row":13,
"col":7,
"isloop":0,
"datas":[1,1,1,2,2,2,2,2,2,2,1,1,1,
2,2,1,2,1,1,1,1,1,2,1,2,2,
2,2,1,2,1,2,1,2,1,2,1,2,2,
2,2,1,2,1,2,1,2,1,2,1,2,2,
2,2,1,1,1,2,1,2,1,1,1,2,2,
2,2,2,2,2,2,1,2,2,2,2,2,2,
2,2,2,2,2,2,0,2,2,2,2,2,2],

"it1":[0,0,0,475,475,475,475,475,475,475,0,0,0,
472,425,0,475,0,0,0,0,0,475,0,425,471,
472,425,0,476,0,0,0,0,0,476,0,425,472,
472,477,0,0,0,471,0,471,0,0,0,477,472,
471,0,0,0,0,471,0,471,0,0,0,0,471,
471,472,472,480,0,471,0,471,479,0,471,472,472,
475,480,0,0,473,474,0,479,0,0,480,0,475],

"it2":[0,0,0,0,0,0,0,0,0,0,0,0,0,
0,3031,0,0,0,0,0,0,0,0,0,3031,0,
0,3021,0,0,0,0,0,0,0,0,0,3021,0,
0,0,0,0,0,2022,0,0,0,0,0,0,0,
0,0,0,0,0,0,0,0,0,0,0,0,0,
0,0,0,0,0,0,0,0,0,0,0,0,0,
0,0,0,0,0,0,0,0,0,0,0,0,0],

"point1": [[12,0],[10,0],[10,4],[8,4],[8,1],[6,1],[6,5]],
"point2": [[0,0],[2,0],[2,4],[4,4],[4,1],[6,1],[6,5]],
"point3": [[12,0],[10,0],[10,4],[8,4],[8,1],[6,1],[6,5]],
"point4": [[0,0],[2,0],[2,4],[4,4],[4,1],[6,1],[6,5]],

"snow":25,
"freeze":50,
"freezeTime":5000,
"freezeDy":100
}
