{
"row":13,
"col":7,
"isloop":1,
"datas":[2,1,1,1,1,1,1,2,2,2,2,2,2,
2,1,1,1,1,2,1,2,2,2,2,2,2,
2,2,2,2,1,2,1,2,2,2,2,2,2,
2,2,2,2,1,2,1,2,2,2,2,2,2,
2,2,2,2,1,2,1,2,2,2,2,2,2,
2,2,2,2,1,2,1,2,2,2,2,2,2,
2,2,2,2,1,1,1,2,2,2,2,2,2],

"it1":[0,0,0,0,0,0,0,483,0,476,479,0,0,
478,0,0,0,0,476,0,0,0,0,473,481,0,
0,475,483,0,0,0,0,478,472,401,401,401,477,
481,0,0,0,0,0,0,0,0,401,403,401,0,
401,401,401,472,0,477,0,475,0,401,401,401,473,
401,403,401,478,0,0,0,483,0,479,0,482,0,
401,401,401,0,0,0,0,0,0,472,475,0,0],

"it2":[],

"point1": [[4,6],[4,1],[1,1],[1,0],[6,0],[6,6],[4,6]],
"point2": [[4,6],[4,1],[1,1],[1,0],[6,0],[6,6],[4,6]],

"snow":25,
"freeze":50,
"freezeTime":5000,
"freezeDy":100
}
