{
"row":13,
"col":7,
"isloop":0,
"datas":[1,3,3,3,3,3,3,3,3,3,3,3,3,
0,3,3,3,3,3,3,3,3,3,3,3,3,
2,2,2,2,2,2,2,2,2,2,2,2,3,
2,2,2,2,2,3,3,3,3,3,3,2,3,
2,2,2,2,2,3,3,3,3,3,3,2,3,
2,2,2,2,2,2,2,2,2,2,2,2,3,
1,3,3,3,3,3,3,3,3,3,3,3,3],

"it1":[0,0,0,0,0,0,0,0,0,0,0,0,0,
0,0,0,0,0,0,0,0,0,0,0,0,0,
472,481,0,479,0,473,403,403,403,403,403,403,0,
483,0,476,482,0,0,0,0,0,0,0,403,0,
0,0,0,0,0,0,0,0,0,0,0,403,0,
401,401,401,401,401,471,403,403,403,403,403,403,0,
0,0,0,0,0,0,0,0,0,0,0,0,0],

"it2":[],

"point1": [[0,6],[0,0]],
"point2": [[0,6],[0,0]],
"point3": [[0,6],[0,0]],
"point4": [[0,6],[0,0]],

"snow":25,
"freeze":50,
"freezeTime":5000,
"freezeDy":100
}
