{
"row":13,
"col":7,
"isloop":0,
"datas":[2,2,2,1,1,1,1,1,2,2,2,2,2,
2,2,2,1,2,2,0,1,1,2,2,2,2,
2,2,2,1,2,2,2,2,1,1,2,2,2,
2,2,2,1,2,2,2,2,2,1,1,2,2,
2,2,2,1,2,2,2,2,2,2,1,1,2,
2,2,2,1,2,2,2,2,2,2,2,1,1,
2,2,2,1,1,1,1,1,1,1,1,1,1],

"it1":[482,0,478,0,0,0,0,0,0,474,406,0,471,
0,0,0,0,471,471,0,0,0,475,0,0,477,
476,401,471,0,471,471,475,475,0,0,481,0,0,
0,482,0,0,478,475,482,0,478,0,0,471,476,
471,0,0,0,0,478,0,0,0,471,0,0,0,
482,0,425,0,471,0,471,474,474,471,425,0,0,
0,0,472,0,0,0,0,0,0,0,0,0,0],

"it2":[0,0,0,0,0,0,0,0,0,0,0,0,0,
0,0,0,0,0,0,0,0,0,0,0,0,0,
0,0,0,0,0,0,0,0,0,0,0,0,0,
0,0,0,0,0,0,0,0,0,0,0,0,0,
0,0,0,0,0,0,0,0,0,0,0,0,0,
0,0,2021,0,0,0,0,0,0,0,2021,0,0,
0,0,0,0,0,0,0,0,0,0,0,0,0],

"point1": [[6,6],[12,6],[12,5],[11,5],[11,4],[10,4],[10,3],[9,3],[9,2],[8,2],[8,1],[7,1],[7,0],[6,0]],
"point2": [[6,6],[3,6],[3,0],[6,0]],
"point3": [[6,6],[12,6],[12,5],[11,5],[11,4],[10,4],[10,3],[9,3],[9,2],[8,2],[8,1],[7,1],[7,0],[6,0]],
"point4": [[6,6],[3,6],[3,0],[6,0]],

"snow":25,
"freeze":50,
"freezeTime":5000,
"freezeDy":100
}
