{
"row":13,
"col":7,
"isloop":0,
"datas":[2,1,1,1,2,2,2,2,2,2,1,1,1,
2,2,2,1,2,2,2,2,2,2,1,1,0,
2,2,2,1,1,1,1,1,1,1,1,1,2,
2,2,2,2,1,2,2,2,1,2,2,1,2,
1,1,1,1,1,2,2,2,1,2,2,1,2,
1,2,2,2,2,2,2,2,1,1,1,1,2,
1,2,2,2,2,2,2,2,2,2,2,2,2],

"it1":[473,0,0,0,477,476,481,0,473,0,0,0,0,
477,471,471,0,0,0,479,0,479,0,0,0,0,
0,479,0,0,0,0,0,0,0,0,0,0,471,
473,473,481,0,0,479,0,471,0,0,477,0,471,
0,0,0,0,0,425,473,477,0,0,0,0,476,
0,472,473,472,479,0,471,0,0,0,0,0,0,
0,473,473,473,471,481,0,425,473,473,479,0,471],

"it2":[0,0,0,0,0,0,0,0,0,0,0,6031,0,
0,0,0,0,0,0,0,0,0,0,0,0,0,
0,0,0,0,0,0,0,0,0,0,0,0,0,
0,0,0,2021,0,0,0,0,0,0,0,0,0,
0,0,0,0,0,2021,0,0,0,0,0,0,0,
0,0,0,0,0,0,0,0,0,0,0,0,0,
0,0,0,0,0,0,0,6031,0,0,0,0,0],

"point1": [[0,6],[0,4],[4,4],[4,2],[8,2],[8,5],[11,5],[11,0],[12,0]],
"point2": [[1,0],[3,0],[3,2],[10,2],[10,0],[12,0]],

"snow":25,
"freeze":50,
"freezeTime":5000,
"freezeDy":100
}
