{
"row":13,
"col":7,
"isloop":0,
"datas":[2,2,2,2,2,2,2,2,2,2,2,2,2,
2,2,2,2,2,2,2,2,2,2,2,2,2,
2,2,2,2,2,2,2,2,2,2,2,2,2,
1,1,1,1,1,1,1,1,1,1,1,1,1,
2,2,2,2,2,2,2,2,2,2,2,2,0,
2,2,2,2,2,2,2,2,2,2,2,2,2,
2,2,2,2,2,2,2,2,2,2,2,2,2],

"it1":[471,473,482,0,476,477,473,482,0,482,0,475,473,
473,475,0,0,0,0,475,0,0,0,0,473,473,
471,480,0,475,475,479,0,403,481,0,471,0,473,
0,0,0,0,0,0,0,0,0,0,0,0,0,
401,473,475,477,479,0,475,475,477,477,473,0,0,
476,483,0,0,483,0,482,0,0,0,478,471,476,
0,0,0,403,0,0,0,0,471,471,0,473,0],

"it2":[],

"point1": [[0,3],[12,3]],
"point2": [[0,3],[12,3]],

"snow":25,
"freeze":50,
"freezeTime":5000,
"freezeDy":100
}
