{
"row":13,
"col":7,
"isloop":0,
"datas":[2,2,2,2,2,2,2,2,2,2,2,2,2,
2,1,1,1,1,1,2,1,1,1,1,1,2,
2,1,2,2,2,1,2,0,2,2,2,1,2,
2,1,2,2,2,1,2,2,2,2,2,1,2,
2,1,1,1,1,1,1,1,1,1,1,1,2,
2,2,2,2,2,1,2,2,2,2,2,2,2,
2,2,2,2,2,1,2,2,2,2,2,2,2],

"it1":[477,401,481,0,471,480,0,472,401,480,0,471,477,
0,0,0,0,0,0,471,0,0,0,0,0,0,
473,0,478,482,0,0,474,0,471,477,473,0,0,
471,0,0,0,0,0,480,0,475,0,471,0,477,
425,0,0,0,0,0,0,0,0,0,0,0,0,
482,0,471,480,0,0,478,481,0,471,477,482,0,
0,0,480,0,401,0,0,472,480,0,0,0,0],

"it2":[0,0,0,0,0,0,0,0,0,0,0,0,0,
0,0,0,0,0,0,0,0,0,0,0,0,0,
0,0,0,0,0,0,0,0,0,0,0,0,0,
0,0,0,0,0,0,0,0,0,0,0,0,0,
6021,0,0,0,0,0,0,0,0,0,0,0,0,
0,0,0,0,0,0,0,0,0,0,0,0,0,
0,0,0,0,0,0,0,0,0,0,0,0,0],

"point1": [[5,6],[5,1],[1,1],[1,4],[11,4],[11,1],[7,1]],
"point2": [[5,6],[5,1],[1,1],[1,4],[11,4],[11,1],[7,1]],

"snow":25,
"freeze":50,
"freezeTime":5000,
"freezeDy":100
}
