{
"row":13,
"col":7,
"isloop":0,
"datas":[2,2,1,1,1,1,2,2,2,2,2,2,2,
2,1,1,2,2,1,1,2,2,2,2,2,2,
2,1,2,2,2,2,1,2,2,2,2,2,2,
2,1,2,2,2,2,1,1,1,1,1,1,1,
2,1,1,2,2,2,2,2,2,2,2,2,0,
2,2,1,1,1,2,2,2,2,2,2,2,2,
2,2,2,2,2,2,2,2,2,2,2,2,2],

"it1":[476,475,0,0,0,0,481,0,471,479,0,471,401,
0,0,0,425,475,0,0,403,483,0,479,0,476,
478,0,477,480,0,478,0,475,0,0,0,475,0,
0,0,0,476,477,0,0,0,0,0,0,0,0,
476,0,0,0,0,483,0,425,475,479,0,0,0,
0,472,0,0,0,0,0,479,0,482,0,479,0,
479,0,401,471,480,0,479,0,473,0,0,479,0],

"it2":[6021,0,0,0,0,0,0,0,0,0,0,0,0,
0,0,0,1021,0,0,0,0,0,0,0,0,0,
0,0,0,0,0,0,0,0,0,0,0,0,0,
0,0,0,0,0,0,0,0,0,0,0,0,0,
0,0,0,0,0,0,0,1021,0,0,0,0,0,
0,0,0,0,0,0,0,0,0,0,0,0,0,
0,0,0,0,0,0,0,0,0,0,0,0,0],

"point1": [[4,5],[2,5],[2,4],[1,4],[1,1],[2,1],[2,0],[5,0],[5,1],[6,1],[6,3],[12,3]],
"point2": [[4,5],[2,5],[2,4],[1,4],[1,1],[2,1],[2,0],[5,0],[5,1],[6,1],[6,3],[12,3]],

"snow":25,
"freeze":50,
"freezeTime":5000,
"freezeDy":100
}
