{
"row":13,
"col":7,
"isloop":1,
"datas":[2,2,2,2,2,1,1,1,2,2,2,2,2,
2,2,2,2,2,1,2,1,2,2,2,2,2,
2,2,2,2,2,1,2,1,2,2,2,2,2,
2,2,1,1,1,1,2,1,1,1,1,2,2,
2,2,1,2,2,2,2,2,2,2,1,2,2,
2,2,1,1,1,1,1,1,1,1,1,2,2,
2,2,2,2,2,2,2,2,2,2,2,2,2],

"it1":[476,479,0,480,0,0,0,0,477,482,0,473,476,
0,401,480,0,478,0,471,0,0,0,0,403,0,
473,477,473,473,0,0,0,0,481,0,471,479,0,
476,0,0,0,0,0,477,0,0,0,0,471,473,
0,403,0,479,0,472,0,0,479,0,0,479,0,
482,0,0,0,0,0,0,0,0,0,0,477,477,
0,0,480,0,473,481,0,472,480,0,401,0,0],

"it2":[],

"point1": [[2,5],[10,5],[10,3],[7,3],[7,0],[5,0],[5,3],[2,3],[2,5]],
"point2": [[2,5],[10,5],[10,3],[7,3],[7,0],[5,0],[5,3],[2,3],[2,5]],

"snow":25,
"freeze":50,
"freezeTime":5000,
"freezeDy":100
}
