{
"row":13,
"col":7,
"isloop":0,
"datas":[1,1,2,2,2,2,2,2,2,2,2,2,1,
1,1,1,2,2,2,2,2,2,2,2,2,1,
1,2,1,1,1,1,2,2,2,2,2,2,1,
1,2,2,2,2,1,1,1,1,1,2,2,1,
1,2,2,2,2,2,2,2,2,1,2,2,1,
1,2,2,2,2,2,2,2,2,1,1,1,1,
0,2,2,2,2,2,2,2,2,2,2,2,2],

"it1":[0,0,425,406,0,478,475,478,471,482,0,475,0,
0,0,0,0,0,0,473,0,473,0,0,475,0,
0,425,0,0,0,0,473,475,473,481,0,475,0,
0,481,0,473,477,0,0,0,0,0,475,0,0,
0,482,0,473,0,479,0,406,0,0,479,0,0,
0,0,0,473,471,473,473,0,0,0,0,0,0,
0,471,472,473,481,0,480,0,479,0,479,0,472],

"it2":[0,0,2021,0,0,0,0,0,0,0,0,0,0,
0,0,0,0,0,0,0,0,0,0,0,0,0,
0,2021,0,0,0,0,0,0,0,0,0,0,0,
0,0,0,0,0,0,0,0,0,0,0,0,0,
0,0,0,0,0,0,0,0,0,0,0,0,0,
0,0,0,0,0,0,0,0,0,0,0,0,0,
0,0,0,0,0,0,0,0,0,0,0,0,0],

"point1": [[12,0],[12,5],[9,5],[9,3],[5,3],[5,2],[2,2],[2,1],[1,1],[1,0],[0,0],[0,5]],
"point2": [[12,0],[12,5],[9,5],[9,3],[5,3],[5,2],[2,2],[2,1],[1,1],[1,0],[0,0],[0,5]],

"snow":25,
"freeze":50,
"freezeTime":5000,
"freezeDy":100
}
