{
"row":13,
"col":7,
"isloop":0,
"datas":[2,2,2,2,2,2,2,2,2,2,2,2,2,
1,1,1,1,1,1,1,2,2,2,2,2,2,
1,2,2,2,2,2,1,2,2,2,2,2,2,
1,2,2,2,2,2,0,2,2,2,2,2,2,
1,2,2,2,2,2,2,2,2,2,2,2,2,
1,1,1,1,1,1,1,2,2,2,2,2,2,
2,2,2,2,2,2,1,2,2,2,2,2,2],

"it1":[475,481,0,472,471,473,0,475,0,471,480,0,471,
0,0,0,0,0,0,0,481,0,480,0,481,0,
0,401,483,0,477,472,0,477,475,471,483,0,471,
0,478,0,0,0,478,0,0,482,0,0,0,478,
0,0,472,479,0,0,472,478,0,0,403,475,0,
0,0,0,0,0,0,0,0,476,474,475,476,474,
401,471,480,0,481,0,0,473,0,480,0,0,471],

"it2":[],

"point1": [[6,6],[6,5],[0,5],[0,1],[6,1],[6,2]],
"point2": [[6,6],[6,5],[0,5],[0,1],[6,1],[6,2]],

"snow":25,
"freeze":50,
"freezeTime":5000,
"freezeDy":100
}
