{
"row":13,
"col":7,
"isloop":0,
"datas":[1,1,1,1,1,1,1,1,1,1,1,1,1,
0,2,2,2,2,2,2,2,2,2,2,2,1,
1,1,1,1,1,1,1,1,1,1,1,1,1,
1,2,2,2,2,2,2,2,2,2,2,2,2,
1,1,1,1,1,1,1,1,1,1,1,1,1,
2,2,2,2,2,2,2,2,2,2,2,2,1,
1,1,1,1,1,1,1,1,1,1,1,1,1],

"it1":[0,0,0,0,0,0,0,0,0,0,0,0,0,
0,0,475,474,475,474,475,474,475,474,475,474,0,
0,0,0,0,0,0,0,0,0,0,0,0,0,
0,473,475,473,475,473,475,473,475,473,475,473,401,
0,0,0,0,0,0,0,0,0,0,0,0,0,
401,475,425,475,425,475,425,475,425,481,0,425,0,
0,0,0,0,0,0,0,0,0,0,0,0,0],

"it2":[0,0,0,0,0,0,0,0,0,0,0,0,0,
0,0,0,1031,0,1031,0,1031,0,1031,0,1031,0,
0,0,0,0,0,0,0,0,0,0,0,0,0,
0,0,4031,0,4031,0,4031,0,4031,0,4031,0,0,
0,0,0,0,0,0,0,0,0,0,0,0,0,
0,0,5031,0,5031,0,5031,0,5031,0,0,6031,0,
0,0,0,0,0,0,0,0,0,0,0,0,0],

"point1": [[0,6],[12,6],[12,4],[0,4],[0,2],[12,2],[12,0],[0,0]],
"point2": [[0,6],[12,6],[12,4],[0,4],[0,2],[12,2],[12,0],[0,0]],

"snow":25,
"freeze":50,
"freezeTime":5000,
"freezeDy":100
}
