{
"row":13,
"col":7,
"isloop":0,
"destroyed1":[[1,4],[1,0]],
"destroyed1":[[1,4],[1,0]],
"datas":[1,1,2,1,1,1,1,1,1,1,1,1,1,
1,2,2,0,2,2,2,2,2,2,2,2,1,
1,2,2,2,2,2,2,2,2,2,2,2,1,
1,2,2,2,2,2,2,2,2,2,2,2,1,
1,2,2,2,2,2,2,2,2,2,2,2,1,
1,1,1,1,1,1,1,1,1,1,1,1,1,
2,2,2,2,2,2,2,2,2,2,2,2,2],

"it1":[0,0,425,0,0,0,0,0,0,0,0,0,0,
0,400,0,0,406,0,476,478,479,0,482,0,0,
0,0,0,473,0,0,0,0,425,476,0,0,0,
0,483,0,480,0,474,481,0,473,0,478,403,0,
0,0,0,425,480,0,480,0,473,474,0,472,0,
0,0,0,0,0,0,0,0,0,0,0,0,0,
401,481,0,473,481,0,474,481,0,0,480,0,425],

"it2":[0,0,3031,0,0,0,0,0,0,0,0,0,0,
0,0,0,0,0,0,0,0,0,0,0,0,0,
0,0,0,0,0,0,0,0,3011,0,0,0,0,
0,0,0,0,0,0,0,0,0,0,0,0,0,
0,0,0,3041,0,0,0,0,0,0,0,0,0,
0,0,0,0,0,0,0,0,0,0,0,0,0,
0,0,0,0,0,0,0,0,0,0,0,0,3021],

"point1": [[1,0],[0,0],[0,5],[12,5],[12,0],[3,0]],
"point2": [[1,0],[0,0],[0,5],[12,5],[12,0],[3,0]],

"snow":25,
"freeze":50,
"freezeTime":5000,
"freezeDy":100
}
