{
"row":13,
"col":7,
"isloop":1,
"datas":[2,2,1,1,1,1,1,1,1,1,1,2,2,
2,2,1,1,1,1,1,1,1,1,1,2,2,
2,2,2,2,2,2,2,2,2,2,2,2,2,
1,1,1,1,1,1,1,1,1,1,1,1,1,
1,2,2,2,2,2,2,2,2,2,2,2,1,
1,1,1,1,1,1,1,1,1,1,1,1,1,
2,2,2,2,2,2,2,2,2,2,2,2,2],

"it1":[483,0,0,0,0,0,0,0,0,0,0,483,0,
0,0,0,0,0,0,0,0,0,0,0,0,0,
475,481,0,401,481,0,475,481,0,401,481,0,475,
0,0,0,0,0,0,0,0,0,0,0,0,0,
0,481,0,475,480,0,475,480,0,475,481,0,0,
0,0,0,0,0,0,0,0,0,0,0,0,0,
0,475,481,0,474,475,401,475,474,481,0,475,0],

"it2":[],

"point1": [[0,5],[12,5],[12,3],[0,3],[0,5]],
"point2": [[2,1],[10,1],[10,0],[2,0],[2,1]],

"snow":25,
"freeze":50,
"freezeTime":5000,
"freezeDy":100
}
