{
"row":13,
"col":7,
"isloop":0,
"datas":[1,1,2,2,2,2,1,2,2,2,2,2,2,
2,1,1,2,2,2,1,2,2,1,1,1,1,
2,2,1,1,2,2,1,2,2,1,2,2,0,
2,2,2,1,1,1,1,2,2,1,1,1,2,
2,2,2,2,1,1,2,2,2,2,2,1,2,
1,1,1,1,1,1,1,1,1,1,1,1,2,
2,2,2,2,2,2,2,2,2,2,2,2,2],

"it1":[0,0,502,502,506,500,0,500,507,0,502,500,0,
503,0,0,500,0,500,0,509,0,0,0,0,0,
506,401,0,0,404,404,0,511,0,0,509,0,0,
0,503,504,0,0,0,0,0,0,0,0,0,500,
401,403,0,503,0,0,509,0,508,0,0,0,502,
0,0,0,0,0,0,0,0,0,0,0,0,503,
507,0,500,502,503,502,502,502,503,508,0,502,0],

"it2":[0,0,0,0,0,0,0,0,0,0,0,0,0,
0,0,0,0,0,0,0,0,0,0,0,0,0,
0,0,0,0,1100,1100,0,0,0,0,0,0,0,
0,0,0,0,0,0,0,0,0,0,0,0,0,
0,0,0,0,0,0,0,0,0,0,0,0,0,
0,0,0,0,0,0,0,0,0,0,0,0,0,
0,0,0,0,0,0,0,0,0,0,0,0,0],

"point1": [[0,5],[11,5],[11,3],[9,3],[9,1],[12,1]],
"point2": [[0,0],[1,0],[1,1],[2,1],[2,2],[3,2],[3,3],[4,3],[4,4],[5,4],[5,5],[11,5],[11,3],[9,3],[9,1],[12,1]],
"point3": [[6,0],[6,3],[5,3],[5,5],[11,5],[11,3],[9,3],[9,1],[12,1]],

"paopaoBuffid":30010

}
