{
"row":13,
"col":7,
"isloop":0,
"destroyed1":[[0,5],[0,4]],
"destroyed2":[[0,1],[0,0]],
"destroyed3":[[0,5],[0,4]],
"destroyed4":[[0,1],[0,0]],
"datas":[1,1,1,1,1,1,1,1,1,1,1,1,2,
2,2,2,2,1,2,2,2,2,2,2,1,2,
2,2,2,2,1,1,1,1,1,1,1,1,2,
2,2,2,2,2,2,2,2,2,2,2,1,1,
1,1,1,1,1,1,1,1,1,1,1,1,0,
2,2,2,2,1,2,2,2,2,2,2,1,2,
2,2,2,2,1,1,1,1,1,1,1,1,2],

"it1":[0,0,0,0,0,0,0,0,0,0,0,0,0,
400,0,401,506,0,404,502,502,502,500,503,0,503,
0,0,503,0,0,0,0,0,0,0,0,0,503,
507,0,508,0,404,401,500,501,502,502,503,0,0,
0,0,0,0,0,0,0,0,0,0,0,0,0,
400,0,506,502,0,404,501,502,502,500,503,0,503,
0,0,0,401,0,0,0,0,0,0,0,0,0],

"it2":[0,0,0,0,0,0,0,0,0,0,0,0,0,
0,0,0,0,0,1100,0,0,0,0,0,0,0,
0,0,0,0,0,0,0,0,0,0,0,0,0,
0,0,0,0,1040,0,0,0,0,0,0,0,0,
0,0,0,0,0,0,0,0,0,0,0,0,0,
0,0,0,0,0,1100,0,0,0,0,0,0,0,
0,0,0,0,0,0,0,0,0,0,0,0,0],

"point1": [[0,4],[11,4],[11,3],[12,3]],
"point2": [[0,0],[11,0],[11,3],[12,3]],
"point3": [[0,4],[4,4],[4,6],[11,6],[11,3],[12,3]],
"point4": [[0,0],[4,0],[4,2],[11,2],[11,3],[12,3]],

"paopaoBuffid":30010

}
