{
"row":13,
"col":7,
"isloop":0,
"datas":[1,1,1,1,1,1,1,2,2,1,1,1,1,
1,2,2,2,2,2,1,1,2,2,2,2,1,
1,1,1,1,1,2,2,1,1,2,2,2,1,
2,2,2,2,1,2,2,0,1,1,2,2,1,
2,2,2,2,1,2,2,2,2,1,2,2,1,
1,1,1,1,1,2,2,2,2,1,1,1,1,
2,2,2,2,2,2,2,2,2,2,2,2,2],

"it1":[0,0,0,0,0,0,0,508,0,0,0,0,0,
0,404,509,0,501,506,0,0,500,509,0,404,0,
0,0,0,0,0,0,500,0,0,500,507,0,0,
406,0,510,0,0,510,0,0,0,0,505,504,0,
0,0,0,0,0,0,0,511,0,0,0,0,0,
0,0,0,0,0,511,0,0,0,0,0,0,0,
508,0,507,0,403,0,0,509,0,500,509,0,0],

"it2":[0,0,0,0,0,0,0,0,0,0,0,0,0,
0,1000,0,0,0,0,0,0,0,0,0,1000,0,
0,0,0,0,0,0,0,0,0,0,0,0,0,
0,0,0,0,0,0,0,0,0,0,0,0,0,
0,0,0,0,0,0,0,0,0,0,0,0,0,
0,0,0,0,0,0,0,0,0,0,0,0,0,
0,0,0,0,0,0,0,0,0,0,0,0,0],

"point1": [[0,5],[4,5],[4,2],[0,2],[0,0],[6,0],[6,1],[7,1],[7,2]],
"point2": [[0,5],[4,5],[4,2],[0,2],[0,0],[6,0],[6,1],[7,1],[7,2]],
"point3": [[9,0],[12,0],[12,5],[9,5],[9,3],[8,3],[8,2],[7,2]],
"point4": [[9,0],[12,0],[12,5],[9,5],[9,3],[8,3],[8,2],[7,2]],

"paopaoBuffid":30010

}
