{
"row":13,
"col":7,
"isloop":0,
"destroyed1":[[6,5],[8,5]],
"destroyed2":[[6,5],[8,5]],
"datas":[1,1,1,1,2,2,2,1,1,1,1,1,1,
1,2,2,2,2,2,2,1,2,2,2,2,1,
1,2,2,2,2,2,2,1,2,2,2,2,0,
1,1,1,1,1,1,1,1,1,1,1,1,2,
2,2,2,2,2,2,2,2,2,2,2,1,2,
2,2,2,2,2,2,2,2,1,1,1,1,2,
2,2,2,2,2,2,2,2,2,2,2,2,2],

"it1":[0,0,0,0,511,0,505,0,0,0,0,0,0,
0,404,500,401,0,0,0,0,510,0,505,0,0,
0,509,0,508,0,507,0,0,0,0,0,503,0,
0,0,0,0,0,0,0,0,0,0,0,0,506,
505,503,505,500,511,0,508,0,509,0,404,0,0,
0,506,0,503,0,0,400,0,0,0,0,0,504,
0,0,509,0,503,401,0,0,509,0,503,503,0],

"it2":[0,0,0,0,0,0,0,0,0,0,0,0,0,
0,1020,0,0,0,0,0,0,0,0,0,0,0,
0,0,0,0,0,0,0,0,0,0,0,0,0,
0,0,0,0,0,0,0,0,0,0,0,0,0,
0,0,0,0,0,0,0,0,0,0,1040,0,0,
0,0,0,0,0,0,0,0,0,0,0,0,0,
0,0,0,0,0,0,0,0,0,0,0,0,0],

"point1": [[8,5],[11,5],[11,3],[7,3],[7,0],[12,0],[12,1]],
"point2": [[8,5],[11,5],[11,3],[7,3],[7,0],[12,0],[12,1]],
"point3": [[3,0],[0,0],[0,3],[7,3],[7,0],[12,0],[12,1]],
"point4": [[3,0],[0,0],[0,3],[7,3],[7,0],[12,0],[12,1]],

"paopaoBuffid":30010

}
