{
"row":13,
"col":7,
"isloop":0,
"datas":[2,3,2,3,2,3,2,2,2,3,3,2,2,
2,3,3,3,3,3,3,3,3,3,1,2,3,
2,3,2,2,2,2,2,3,2,3,0,3,2,
3,3,3,2,3,2,2,2,2,2,2,2,2,
2,3,2,2,2,3,2,3,2,3,2,3,2,
3,3,3,2,3,2,2,3,2,3,2,2,3,
1,3,2,2,2,3,2,3,2,3,2,3,2],

"it1":[401,0,404,0,401,0,404,500,401,0,0,506,401,
500,0,0,0,0,0,0,0,0,0,0,0,0,
404,0,401,500,404,506,401,0,404,0,0,0,404,
0,0,0,504,0,0,507,0,500,507,0,509,0,
401,0,404,0,401,0,404,0,401,0,404,0,401,
0,0,0,504,0,507,0,0,500,0,507,0,0,
0,0,401,0,404,0,401,0,404,0,401,0,404],

"it2":[0,0,904,0,0,0,903,0,0,0,0,0,0,
0,0,0,0,0,0,0,0,0,0,0,0,0,
901,0,0,0,902,0,0,0,904,0,0,0,903,
0,0,0,0,0,0,0,0,0,0,0,0,0,
0,0,901,0,0,0,902,0,0,0,903,0,0,
0,0,0,0,0,0,0,0,0,0,0,0,0,
0,0,0,0,901,0,0,0,902,0,0,0,904],

"point1": [[0,6],[10,1]],
"point2": [[0,6],[10,1]],
"point3": [[0,6],[10,1]],

"paopaoBuffid":30010

}
