{
"row":13,
"col":7,
"isloop":0,
"iswood":1,
"datas":[2,2,2,2,2,2,2,2,2,4,2,2,2,
2,4,4,2,2,2,2,4,2,2,2,4,2,
2,2,2,3,3,1,2,2,2,2,4,4,2,
2,2,2,3,2,0,2,2,2,4,4,2,2,
2,4,4,3,2,2,2,2,4,4,2,2,2,
2,4,4,3,4,2,2,4,4,2,2,4,2,
1,3,3,3,3,3,3,3,2,2,2,2,2],

"it1":[627,0,628,0,620,629,0,401,622,0,627,0,620,
624,0,0,626,0,0,0,0,620,624,620,0,624,
0,406,0,0,0,0,626,0,623,0,0,0,0,
625,0,0,0,622,0,630,0,0,0,0,628,0,
0,0,0,0,628,0,0,0,0,0,625,626,0,
620,0,0,0,0,628,0,0,0,620,0,0,621,
0,0,0,0,0,0,0,0,628,0,622,627,0],

"it2":[],

"point1": [[0,6],[5,2]],
"point2": [[0,6],[5,2]],
"point3": [[0,6],[5,2]]

}
