{
"row":13,
"col":7,
"isloop":0,
"datas":[2,2,2,1,1,1,1,1,1,1,1,1,2,
2,2,2,1,2,2,2,2,2,2,2,1,2,
1,1,1,1,2,1,1,1,1,2,2,1,2,
1,2,2,2,2,1,2,2,1,2,2,1,2,
1,2,1,1,1,1,2,2,1,2,2,1,2,
1,2,1,2,2,2,2,2,1,1,1,1,2,
1,2,0,2,2,2,2,2,2,2,2,2,2],

"it1":[505,507,0,0,0,0,0,0,0,0,0,0,401,
0,404,401,0,507,0,508,0,404,511,0,0,505,
0,0,0,0,404,0,0,0,0,0,0,0,0,
0,509,0,507,0,0,504,504,0,510,0,0,506,
0,505,0,0,0,0,0,0,0,0,0,0,0,
0,0,0,501,401,404,509,0,0,0,0,0,502,
0,503,0,502,503,509,0,508,0,501,500,0,503],

"it2":[0,0,0,0,0,0,0,0,0,0,0,0,0,
0,1100,0,0,0,0,0,0,1100,0,0,0,0,
0,0,0,0,1010,0,0,0,0,0,0,0,0,
0,0,0,0,0,0,0,0,0,0,0,0,0,
0,0,0,0,0,0,0,0,0,0,0,0,0,
0,0,0,0,0,1100,0,0,0,0,0,0,0,
0,0,0,0,0,0,0,0,0,0,0,0,0],

"point1": [[0,6],[0,2],[3,2],[3,0],[11,0],[11,5],[8,5],[8,2],[5,2],[5,4],[2,4],[2,5]],
"point2": [[0,6],[0,2],[3,2],[3,0],[11,0],[11,5],[8,5],[8,2],[5,2],[5,4],[2,4],[2,5]],

"paopaoBuffid":30010

}
