{
"row":13,
"col":7,
"isloop":0,
"datas":[1,1,1,1,1,2,2,2,1,1,2,1,2,
1,2,2,2,1,2,2,2,1,0,2,1,2,
1,1,2,1,1,2,2,2,1,2,2,1,2,
2,1,2,1,1,1,1,1,1,2,2,1,2,
2,1,2,2,2,2,2,2,2,2,2,1,2,
2,1,1,1,1,1,1,1,1,2,2,1,2,
2,2,2,2,2,2,2,2,1,1,1,1,2],

"it1":[0,0,0,0,0,503,509,0,0,0,506,0,503,
0,404,404,404,0,511,0,0,0,0,0,0,506,
0,0,506,0,0,0,0,503,0,511,0,0,0,
506,0,0,0,0,0,0,0,0,0,0,0,504,
0,0,509,0,500,508,0,507,0,404,404,0,0,
503,0,0,0,0,0,0,0,0,404,404,0,506,
0,509,0,501,502,509,0,503,0,0,0,0,0],

"it2":[0,0,0,0,0,0,0,0,0,0,0,0,0,
0,1100,1100,1100,0,0,0,0,0,0,0,0,0,
0,0,0,0,0,0,0,0,0,0,0,0,0,
0,0,0,0,0,0,0,0,0,0,0,0,0,
0,0,0,0,0,0,0,0,0,1100,1100,0,0,
0,0,0,0,0,0,0,0,0,1100,1100,0,0,
0,0,0,0,0,0,0,0,0,0,0,0,0],

"point1": [[11,0],[11,6],[8,6],[8,5],[1,5],[1,2],[0,2],[0,0],[4,0],[4,2],[3,2],[3,3],[8,3],[8,0],[9,0]],
"point2": [[11,0],[11,6],[8,6],[8,5],[1,5],[1,2],[0,2],[0,0],[4,0],[4,2],[3,2],[3,3],[8,3],[8,0],[9,0]],

"paopaoBuffid":30010

}
