{
"row":13,
"col":7,
"isloop":0,
"datas":[2,2,2,2,2,2,2,2,2,2,2,2,2,
2,2,2,2,1,2,1,1,1,2,2,2,2,
2,2,2,2,1,2,0,2,1,2,2,2,2,
2,2,2,2,1,2,2,2,1,2,2,2,2,
2,2,2,2,1,1,1,1,1,2,2,2,2,
2,2,2,2,2,2,2,2,2,2,2,2,2,
2,2,2,2,2,2,2,2,2,2,2,2,2],

"it1":[504,500,406,0,508,0,509,0,500,0,510,0,505,
0,503,0,0,0,506,0,0,0,504,0,0,0,
509,0,506,404,0,0,0,503,0,0,506,507,0,
503,505,0,503,0,404,509,0,0,506,0,510,0,
401,0,510,0,0,0,0,0,0,0,401,0,0,
510,0,0,0,403,403,403,403,403,404,504,510,0,
0,0,503,509,0,503,508,0,508,0,0,0,0],

"it2":[0,0,0,0,0,0,0,0,0,0,0,0,0,
0,0,0,0,0,0,0,0,0,0,0,0,0,
0,0,0,1030,0,0,0,0,0,0,0,0,0,
0,0,0,0,0,1330,0,0,0,0,0,0,0,
0,0,0,0,0,0,0,0,0,0,0,0,0,
0,0,0,0,0,0,0,0,0,1030,0,0,0,
0,0,0,0,0,0,0,0,0,0,0,0,0],

"point1": [[4,1],[4,4],[8,4],[8,1],[6,1]],
"point2": [[4,1],[4,4],[8,4],[8,1],[6,1]],

"paopaoBuffid":30010

}
