{
"row":13,
"col":7,
"isloop":0,
"datas":[2,2,1,1,1,1,1,1,1,2,1,1,1,
1,1,1,2,1,2,2,2,1,2,0,2,1,
1,2,2,2,1,2,2,2,1,2,2,2,1,
1,2,2,2,1,2,2,2,1,2,2,2,1,
1,2,2,2,1,2,2,2,1,2,2,2,1,
1,2,2,2,1,2,2,2,1,2,2,1,1,
1,1,1,1,1,2,1,1,1,1,1,1,2],

"it1":[426,0,0,0,0,0,0,0,0,430,0,0,0,
0,0,0,0,0,432,434,0,0,0,0,0,0,
0,430,434,0,0,0,0,0,0,432,433,0,0,
0,0,0,0,0,433,0,432,0,0,0,0,0,
0,433,0,430,0,0,0,0,0,434,0,423,0,
0,0,0,0,0,432,426,0,0,0,0,0,0,
0,0,0,0,0,0,0,0,0,0,0,0,6011],

"it2":[0,0,0,0,0,0,0,0,0,0,0,0,0,
0,0,0,0,0,0,0,0,0,0,0,0,0,
0,0,0,0,0,0,0,0,0,0,0,0,0,
0,0,0,0,0,0,0,0,0,0,0,0,0,
0,0,0,0,0,0,0,0,0,0,0,0,0,
0,0,0,0,0,0,0,0,0,2011,0,0,0,
0,0,0,0,0,0,0,0,0,0,0,0,0],

"point1": [[4,1],[4,6],[0,6],[0,1],[2,1],[2,0],[8,0],[8,6],[11,6],[11,5],[12,5],[12,0],[10,0]],
"point2": [[4,1],[4,6],[0,6],[0,1],[2,1],[2,0],[8,0],[8,6],[11,6],[11,5],[12,5],[12,0],[10,0]],
"point3": [[6,6],[8,6],[11,6],[11,5],[12,5],[12,0],[10,0]]

}
