{
"row":13,
"col":7,
"isloop":0,
"iswood":1,
"datas":[4,4,1,1,1,1,1,1,1,1,1,4,2,
4,4,4,2,2,2,2,2,2,2,1,4,4,
2,4,1,1,1,1,1,1,1,1,1,4,2,
4,4,1,2,2,2,2,2,2,2,2,4,2,
2,4,1,2,4,4,4,4,4,4,4,4,4,
4,4,1,1,1,1,1,1,1,1,1,4,2,
2,4,1,1,1,1,1,1,1,1,1,4,2],

"it1":[0,0,0,0,0,0,0,0,0,0,0,0,411,
0,0,0,0,621,621,621,621,621,621,0,0,0,
410,0,0,0,0,0,0,0,0,0,0,0,401,
0,0,0,621,621,621,621,621,621,621,621,0,401,
401,0,0,621,0,0,0,0,0,0,0,0,0,
0,0,0,0,0,0,0,0,0,0,0,0,411,
410,0,0,0,0,0,0,0,0,0,0,0,401],

"it2":[],

"point1": [[2,6],[10,6],[10,5],[2,5],[2,2],[10,2],[10,0],[2,0]],
"point2": [[2,6],[10,6],[10,5],[2,5],[2,2],[10,2],[10,0],[2,0]]

}
