{
"row":13,
"col":7,
"isloop":0,
"datas":[2,1,1,1,1,2,2,2,1,1,1,1,2,
2,1,2,2,1,2,2,2,1,2,2,1,2,
2,1,2,2,1,2,2,2,1,2,2,1,2,
2,1,1,1,1,1,1,1,1,1,1,1,2,
2,2,2,2,1,2,0,2,1,2,2,2,2,
2,2,2,2,1,2,2,2,1,2,2,2,2,
2,2,2,1,1,2,2,2,1,1,2,2,2],

"it1":[502,0,0,0,0,506,500,0,0,0,0,0,401,
0,0,500,503,0,0,511,0,0,406,0,0,500,
504,0,503,401,0,404,0,0,0,0,0,0,506,
0,0,0,0,0,0,0,0,0,0,0,0,0,
510,0,501,505,0,506,0,404,0,507,0,500,401,
0,0,505,0,0,0,403,506,0,501,511,0,500,
508,0,0,0,0,509,0,0,0,0,0,0,403],

"it2":[0,0,0,0,0,0,0,0,0,0,0,0,0,
0,0,0,0,0,0,0,0,0,0,0,0,0,
0,0,0,0,0,1330,0,0,0,0,0,0,0,
0,0,0,0,0,0,0,0,0,0,0,0,0,
0,0,0,7011,0,0,0,1330,0,0,0,0,0,
0,0,0,0,0,0,0,0,0,0,0,0,0,
0,0,0,0,0,0,0,0,0,0,0,0,0],

"point1": [[3,6],[4,6],[4,0],[1,0],[1,3],[6,3]],
"point2": [[3,6],[4,6],[4,0],[1,0],[1,3],[6,3]],
"point3": [[9,6],[8,6],[8,0],[11,0],[11,3],[6,3]],
"point4": [[9,6],[8,6],[8,0],[11,0],[11,3],[6,3]],

"paopaoBuffid":30010

}
