{
"row":13,
"col":7,
"isloop":0,
"destroyed1":[[0,5],[1,4]],
"destroyed2":[[0,5],[1,4]],
"destroyed3":[[0,5],[1,4]],
"datas":[2,2,2,2,2,2,2,2,2,1,1,1,1,
2,2,2,2,2,2,2,1,1,1,2,2,0,
2,2,2,2,2,1,1,1,2,2,2,2,2,
2,2,2,1,1,1,2,2,2,2,2,2,2,
2,1,1,1,2,2,2,2,2,2,2,2,2,
2,2,2,2,2,2,2,2,2,2,2,2,2,
2,2,2,2,2,2,2,2,2,2,2,2,2],

"it1":[504,401,509,0,505,510,0,507,0,0,0,0,0,
0,500,506,404,0,0,0,0,0,0,504,0,0,
511,0,0,507,0,0,0,0,507,0,0,510,0,
0,0,501,0,0,0,503,507,0,500,505,0,0,
503,0,0,0,511,0,509,0,404,506,0,501,504,
400,0,509,0,0,0,505,406,0,0,503,505,0,
0,0,503,509,0,501,0,0,0,507,0,0,502],

"it2":[0,0,0,0,0,0,0,0,0,0,0,0,0,
0,0,2041,1100,0,0,0,0,0,0,0,0,0,
0,0,0,0,0,0,0,0,0,0,0,0,0,
0,0,0,0,0,0,0,0,0,0,0,0,0,
0,0,0,0,0,0,0,0,1100,0,0,0,0,
0,0,0,0,0,0,0,0,0,0,2041,0,0,
0,0,0,0,0,0,0,0,0,0,0,0,0],

"point1": [[1,4],[3,4],[3,3],[5,3],[5,2],[7,2],[7,1],[9,1],[9,0],[12,0]],
"point2": [[1,4],[3,4],[3,3],[5,3],[5,2],[7,2],[7,1],[9,1],[9,0],[12,0]],
"point3": [[1,4],[3,4],[3,3],[5,3],[5,2],[7,2],[7,1],[9,1],[9,0],[12,0]],

"paopaoBuffid":30010

}
