{
"row":13,
"col":7,
"isloop":0,
"datas":[2,2,2,2,2,2,2,1,1,1,1,1,2,
2,2,2,2,2,2,2,1,2,2,2,1,2,
2,2,2,2,2,2,2,1,2,2,2,1,2,
2,2,2,1,1,1,1,1,1,1,1,1,2,
2,2,2,1,2,2,2,1,2,2,2,2,2,
1,1,1,1,2,2,2,1,1,1,1,1,1,
2,2,2,2,2,2,2,2,2,2,2,2,0],

"it1":[406,0,501,508,0,500,504,0,0,0,0,0,506,
0,0,507,0,503,505,0,0,404,404,404,0,0,
501,511,0,509,0,0,502,0,404,404,404,0,401,
506,0,0,0,0,0,0,0,0,0,0,0,500,
0,507,0,0,505,500,502,0,500,509,0,508,0,
0,0,0,0,0,510,0,0,0,0,0,0,0,
501,507,0,401,500,0,0,0,508,0,509,0,0],

"it2":[0,0,0,0,0,0,0,0,0,0,0,0,0,
0,0,0,0,0,0,0,0,1100,1100,1100,0,0,
0,0,0,0,0,0,0,0,1100,1100,1100,0,0,
0,0,0,0,0,0,0,0,0,0,0,0,0,
0,0,0,0,0,0,0,0,0,0,0,0,0,
0,0,0,0,0,0,0,0,0,0,0,0,0,
0,0,0,0,0,0,0,0,0,0,0,0,0],

"point1": [[0,5],[3,5],[3,3],[11,3],[11,0],[7,0],[7,5],[12,5]],
"point2": [[0,5],[3,5],[3,3],[11,3],[11,0],[7,0],[7,5],[12,5]],

"paopaoBuffid":30010

}
