{
"row":13,
"col":7,
"isloop":0,
"datas":[1,1,1,1,1,2,2,2,1,1,1,1,1,
2,2,2,2,1,2,2,2,1,2,2,2,2,
2,2,2,2,1,2,2,2,1,2,2,2,2,
2,1,1,1,1,1,1,1,1,1,1,1,2,
2,1,2,2,2,2,0,2,2,2,2,1,2,
2,1,2,2,2,2,2,2,2,2,2,1,2,
2,1,2,2,2,2,2,2,2,2,2,1,2],

"it1":[0,0,0,0,0,505,401,505,0,0,0,0,0,
511,0,500,404,0,0,506,0,0,404,500,511,0,
0,0,508,0,0,503,0,503,0,508,0,0,0,
505,0,0,0,0,0,0,0,0,0,0,0,505,
0,0,502,511,0,0,0,0,511,0,502,0,0,
404,0,504,0,0,503,506,503,0,0,504,0,404,
401,0,0,501,509,0,0,509,0,501,0,0,401],

"it2":[0,0,0,0,0,0,0,0,0,0,0,0,0,
0,0,0,1100,0,0,0,0,0,1100,0,0,0,
0,0,0,0,0,0,0,0,0,0,0,0,0,
0,0,0,0,0,0,0,0,0,0,0,0,0,
0,0,0,0,0,0,0,0,0,0,0,0,0,
1100,0,0,0,0,0,0,0,0,0,0,0,1100,
0,0,0,0,0,0,0,0,0,0,0,0,0],

"point1": [[1,6],[1,3],[6,3]],
"point2": [[11,6],[11,3],[6,3]],
"point3": [[0,0],[4,0],[4,3],[6,3]],
"point4": [[12,0],[8,0],[8,3],[6,3]],

"paopaoBuffid":30010

}
