{
"row":13,
"col":7,
"isloop":0,
"datas":[2,2,2,2,2,2,1,1,1,1,2,2,2,
2,2,2,2,2,2,1,2,2,1,1,2,2,
2,2,2,2,2,2,0,2,2,2,1,1,2,
2,1,1,1,1,1,1,1,1,1,1,1,2,
2,1,1,2,2,2,1,2,2,2,2,2,2,
2,2,1,1,2,2,1,2,2,2,2,2,2,
2,2,2,1,1,1,1,2,2,2,2,2,2],

"it1":[401,509,0,500,503,506,0,0,0,0,503,0,502,
502,504,510,0,403,0,0,510,0,0,0,507,0,
504,0,0,0,509,0,0,0,0,500,0,0,503,
0,0,0,0,0,0,0,0,0,0,0,0,504,
503,0,0,404,511,0,0,506,500,406,0,404,0,
510,0,0,0,0,0,0,0,403,0,0,503,505,
0,0,503,0,0,0,0,404,509,0,508,0,0],

"it2":[0,0,0,0,0,0,0,0,0,0,0,0,0,
0,0,0,0,0,0,0,0,0,0,0,0,0,
0,0,0,0,0,0,0,0,0,0,0,0,0,
0,0,0,0,0,0,0,0,0,0,0,0,0,
0,0,0,1330,0,0,0,0,0,0,0,1330,0,
0,0,0,0,0,0,0,0,0,0,0,0,0,
0,0,0,0,0,0,0,1330,0,0,0,0,0],

"point1": [[6,4],[6,6],[3,6],[3,5],[2,5],[2,4],[1,4],[1,3],[11,3],[11,2],[10,2],[10,1],[9,1],[9,0],[6,0],[6,1]],
"point2": [[6,4],[6,6],[3,6],[3,5],[2,5],[2,4],[1,4],[1,3],[11,3],[11,2],[10,2],[10,1],[9,1],[9,0],[6,0],[6,1]],

"paopaoBuffid":30010

}
