{
"row":13,
"col":7,
"isloop":0,
"destroyed1":[[0,5],[0,4]],
"destroyed2":[[11,1],[11,0]],
"destroyed3":[[0,5],[0,4]],
"destroyed4":[[11,1],[11,0]],
"datas":[2,2,2,2,2,2,2,2,2,2,1,1,2,
2,2,2,2,2,2,2,2,2,2,1,2,2,
2,2,2,2,2,2,2,2,2,2,1,2,2,
2,1,1,1,1,1,1,1,1,1,1,2,2,
1,1,2,2,2,2,0,2,2,2,2,2,2,
2,2,2,2,2,2,2,2,2,2,2,2,2,
2,2,2,2,2,2,2,2,2,2,2,2,2],

"it1":[503,509,0,401,504,500,508,0,506,401,0,0,404,
510,0,506,500,0,508,0,505,0,503,0,400,0,
0,0,0,501,507,0,0,0,508,0,0,0,0,
404,0,0,0,0,0,0,0,0,0,0,509,0,
0,0,510,0,507,0,0,504,507,0,511,0,401,
400,0,0,0,503,505,502,0,508,0,0,0,506,
0,0,401,508,0,0,509,0,503,508,0,500,0],

"it2":[0,0,0,0,0,0,0,0,0,0,0,0,1320,
0,0,0,0,0,0,0,0,0,0,0,0,0,
0,0,0,0,0,0,0,0,0,0,0,0,0,
1320,0,0,0,0,0,0,0,0,0,0,0,0,
0,0,0,0,0,0,0,0,0,0,0,0,0,
0,0,0,0,0,0,0,0,0,0,0,0,0,
0,0,0,0,0,0,0,0,0,0,0,0,0],

"point1": [[0,4],[1,4],[1,3],[6,3]],
"point2": [[11,0],[10,0],[10,3],[6,3]],
"point3": [[0,4],[1,4],[1,3],[6,3]],
"point4": [[11,0],[10,0],[10,3],[6,3]],

"paopaoBuffid":30010

}
