{
"row":13,
"col":7,
"isloop":0,
"datas":[2,2,2,2,2,2,1,1,1,1,1,2,2,
2,2,1,1,1,1,1,1,1,1,1,2,2,
2,2,1,1,1,1,1,2,2,2,2,2,2,
2,2,2,2,2,2,1,2,2,2,2,2,2,
1,1,2,2,1,1,1,1,1,1,1,2,2,
2,1,2,2,1,2,0,2,2,2,1,1,1,
2,1,1,1,1,2,2,2,2,2,2,2,1],

"it1":[502,509,0,508,0,404,0,0,0,0,0,401,505,
502,401,0,0,0,0,0,0,0,0,0,504,0,
510,0,0,0,0,0,0,401,500,511,0,0,500,
0,0,502,506,507,0,0,509,0,0,0,501,506,
0,0,404,0,0,0,0,0,0,0,0,404,0,
401,0,508,0,0,500,0,0,507,0,0,0,0,
500,0,0,0,0,0,503,509,0,508,0,500,0],

"it2":[0,0,0,0,0,1040,0,0,0,0,0,0,0,
0,0,0,0,0,0,0,0,0,0,0,0,0,
0,0,0,0,0,0,0,0,0,0,0,0,0,
0,0,0,0,0,0,0,0,0,0,0,0,0,
0,0,1040,0,0,0,0,0,0,0,0,1040,0,
0,0,0,0,0,0,0,0,0,0,0,0,0,
0,0,0,0,0,0,0,0,0,0,0,0,0],

"point1": [[0,4],[1,4],[1,6],[4,6],[4,4],[6,4]],
"point2": [[12,6],[12,5],[10,5],[10,4],[6,4]],
"point3": [[0,4],[1,4],[1,6],[4,6],[4,4],[6,4]],
"point4": [[12,6],[12,5],[10,5],[10,4],[6,4]],
"point5": [[6,0],[10,0],[10,1],[2,1],[2,2],[6,2],[6,4]],

"paopaoBuffid":30010

}
