{
"row":13,
"col":7,
"isloop":0,
"datas":[3,3,3,3,3,3,3,3,3,3,3,3,1,
3,2,2,2,2,3,2,3,2,2,2,2,3,
3,2,2,2,2,3,3,3,2,2,2,2,3,
3,3,3,3,3,3,1,3,3,3,3,3,3,
3,2,2,2,2,3,0,3,2,2,2,2,3,
3,2,2,2,2,3,2,3,2,2,2,2,3,
1,3,3,3,3,3,3,3,3,3,3,3,3],

"it1":[0,0,0,0,0,0,0,0,0,0,0,0,0,
0,404,511,0,401,0,503,0,401,511,0,404,0,
0,401,0,0,503,0,0,0,503,0,0,401,0,
0,0,0,0,0,0,0,0,0,0,0,0,0,
0,401,511,0,503,0,0,0,503,511,0,401,0,
0,404,0,0,401,0,503,0,401,0,0,404,0,
0,0,0,0,0,0,0,0,0,0,0,0,0],

"it2":[0,0,0,0,0,0,0,0,0,0,0,0,0,
0,1100,0,0,0,0,0,0,0,0,0,1100,0,
0,0,0,0,0,0,0,0,0,0,0,0,0,
0,0,0,0,0,0,0,0,0,0,0,0,0,
0,0,0,0,0,0,0,0,0,0,0,0,0,
0,1100,0,0,0,0,0,0,0,0,0,1100,0,
0,0,0,0,0,0,0,0,0,0,0,0,0],

"point1": [[0,6],[6,3]],
"point2": [[12,0],[6,3]],
"point3": [[0,6],[6,3]],
"point4": [[12,0],[6,3]],

"paopaoBuffid":30010

}
