{
"row":13,
"col":7,
"isloop":0,
"datas":[2,2,2,2,1,1,1,1,1,1,1,2,2,
2,2,2,2,1,2,2,2,1,1,1,2,2,
2,2,2,2,2,2,2,1,1,1,1,2,2,
2,2,2,2,2,2,2,1,2,1,1,2,2,
2,2,2,1,1,1,1,1,1,1,1,2,2,
2,2,2,1,2,2,2,2,0,2,1,2,2,
2,2,2,1,1,1,1,1,1,1,1,2,2],

"it1":[506,500,501,425,0,0,0,0,0,0,0,506,502,
0,508,0,506,0,503,500,404,0,0,0,0,401,
503,504,502,0,500,511,0,0,0,0,0,510,0,
401,0,505,508,0,0,0,0,404,0,0,0,0,
510,0,0,0,0,0,0,0,0,0,0,505,500,
0,0,501,0,500,509,0,500,0,404,0,0,500,
507,0,0,0,0,0,0,0,0,0,0,507,0],

"it2":[0,0,0,1360,0,0,0,0,0,0,0,0,0,
0,0,0,0,0,0,0,1330,0,0,0,0,0,
0,0,0,0,0,0,0,0,0,0,0,0,0,
0,0,0,0,0,0,0,0,1040,0,0,0,0,
0,0,0,0,0,0,0,0,0,0,0,0,0,
0,0,0,0,0,0,0,0,0,1330,0,0,0,
0,0,0,0,0,0,0,0,0,0,0,0,0],

"point1": [[4,1],[4,0],[10,0],[10,6],[3,6],[3,4],[7,4],[7,2],[8,2],[8,1],[9,1],[9,4],[8,4]],
"point2": [[4,1],[4,0],[10,0],[10,6],[3,6],[3,4],[7,4],[7,2],[8,2],[8,1],[9,1],[9,4],[8,4]],

"paopaoBuffid":30010

}
