{
"row":13,
"col":7,
"isloop":0,
"datas":[1,1,1,1,1,1,1,1,1,1,1,1,1,
1,2,2,2,2,2,2,2,2,2,2,2,1,
1,2,2,2,2,2,2,2,2,2,2,2,1,
1,2,2,2,2,2,2,2,2,2,2,2,1,
1,2,2,2,2,2,2,2,2,2,2,2,1,
0,2,2,2,2,2,2,2,2,2,2,2,1,
1,1,1,1,1,1,1,1,1,1,1,1,1],

"it1":[0,0,0,0,0,0,0,0,0,0,0,0,0,
0,401,507,0,502,509,0,0,504,508,0,401,0,
0,404,505,500,406,0,509,0,0,506,501,504,0,
0,504,0,506,0,0,401,406,0,0,505,0,0,
0,0,501,0,504,509,0,0,0,500,0,404,0,
0,401,508,0,0,0,509,0,502,507,0,401,0,
0,0,0,0,0,0,0,0,0,0,0,0,0],

"it2":[0,0,0,0,0,0,0,0,0,0,0,0,0,
0,0,0,0,0,0,0,0,0,0,0,0,0,
0,902,0,0,0,0,0,0,0,0,0,0,0,
0,0,0,0,0,0,0,0,0,0,0,0,0,
0,0,0,0,0,0,0,0,0,0,0,902,0,
0,0,0,0,0,0,0,0,0,0,0,0,0,
0,0,0,0,0,0,0,0,0,0,0,0,0],

"point1": [[0,6],[12,6],[12,0],[0,0],[0,4]],
"point2": [[0,6],[12,6],[12,0],[0,0],[0,4]],

"paopaoBuffid":30010

}
