{
"row":13,
"col":7,
"isloop":0,
"datas":[2,4,4,2,2,2,2,2,2,2,4,4,2,
4,1,1,1,1,1,1,1,1,1,1,1,4,
4,1,2,2,2,2,2,2,2,2,2,1,4,
2,1,4,4,2,2,2,2,2,2,2,1,2,
2,1,1,1,1,2,2,2,2,2,2,1,2,
4,2,2,4,1,2,2,2,2,2,2,0,2,
4,4,4,4,1,2,2,2,2,2,2,2,2],

"it1":[401,0,0,549,0,547,0,542,547,0,0,0,401,
0,0,0,0,0,0,0,0,0,0,0,0,0,
0,0,540,542,542,540,542,542,542,0,401,0,0,
546,0,0,0,541,548,0,542,541,541,542,0,542,
0,0,0,0,0,551,0,542,542,542,542,0,542,
0,401,401,0,0,0,0,541,541,541,541,0,545,
0,0,0,0,0,547,0,541,542,540,547,0,0],

"it2":[0,0,0,0,0,0,0,0,0,0,0,0,0,
0,0,0,0,0,0,0,0,0,0,0,0,0,
0,0,0,0,0,0,0,0,0,0,0,0,0,
5021,0,0,0,0,0,0,0,0,0,0,0,0,
5021,0,0,0,0,0,0,0,0,0,0,0,0,
0,0,0,0,0,0,0,0,0,0,0,0,0,
0,0,0,0,0,0,0,0,0,0,0,0,0],

"point1": [[4,6],[4,4],[1,4],[1,1],[11,1],[11,4]],
"point2": [[4,6],[4,4],[1,4],[1,1],[11,1],[11,4]],

"jiaotuFlag":1,
"jiaotuTime":15000,
"jiaotuEft":["buff_jiaotu1","buff_jiaotu2","buff_jiaotu3","buff_jiaotu4"]

}
