{
"row":13,
"col":7,
"isloop":0,
"datas":[2,1,1,1,1,1,1,1,1,1,1,1,2,
2,1,2,2,2,0,2,2,2,2,2,1,2,
2,1,2,2,2,2,2,2,2,2,2,1,2,
2,1,2,1,1,1,1,1,1,1,2,1,2,
2,1,2,1,2,2,2,2,2,1,2,1,2,
2,1,2,1,2,2,2,2,2,1,1,1,2,
2,1,2,1,1,1,1,2,2,2,2,2,2],

"it1":[401,0,0,0,0,0,0,0,0,0,0,0,401,
540,0,541,551,0,0,541,541,550,0,0,0,541,
544,0,546,0,0,401,542,541,0,0,546,0,544,
0,0,0,0,0,0,0,0,0,0,0,0,0,
542,0,541,0,541,542,549,0,540,0,541,0,544,
540,0,541,0,542,542,542,541,542,0,0,0,0,
401,0,541,0,0,0,0,540,541,540,401,540,540],

"it2":[],

"point1": [[1,6],[1,0],[5,0]],
"point2": [[6,6],[3,6],[3,3],[9,3],[9,5],[11,5],[11,0],[5,0]],

"jiaotuFlag":1,
"jiaotuTime":15000,
"jiaotuEft":["buff_jiaotu1","buff_jiaotu2","buff_jiaotu3","buff_jiaotu4"]

}
