{
"row":13,
"col":7,
"isloop":0,
"datas":[2,1,3,3,3,3,3,3,3,3,3,1,2,
2,3,3,3,3,3,3,3,3,3,3,0,2,
2,3,3,3,3,3,3,3,3,3,3,3,2,
2,3,3,3,3,3,3,3,3,3,3,3,2,
2,3,3,3,3,3,3,3,3,3,3,3,2,
2,3,3,3,3,3,3,3,3,3,3,3,2,
2,3,3,3,3,3,3,3,3,3,3,3,2],

"it1":[541,0,0,0,0,0,0,0,0,0,0,0,540,
541,0,0,0,0,0,0,0,0,0,0,0,401,
401,0,0,0,0,0,0,0,0,0,0,0,544,
541,0,0,0,0,0,0,0,0,0,0,0,0,
401,0,0,0,0,0,0,0,0,0,0,0,401,
540,0,0,0,0,0,0,0,0,0,0,0,401,
540,0,0,0,0,0,0,0,0,0,0,0,401],

"it2":[],

"point1":[[1,0],[11,0]],

"jiaotuFlag":1,
"jiaotuTime":15000,
"jiaotuEft":["buff_jiaotu1","buff_jiaotu2","buff_jiaotu3","buff_jiaotu4"]

}
