{
"row":13,
"col":7,
"isloop":0,
"datas":[2,2,2,2,2,2,2,2,2,2,2,2,2,
2,2,2,2,2,2,2,2,2,2,1,1,1,
2,2,1,1,1,1,1,1,1,2,1,2,1,
2,2,2,2,2,2,2,2,1,2,1,1,1,
2,2,2,2,2,2,2,2,1,1,2,0,1,
2,2,2,2,2,2,2,2,2,1,2,2,1,
2,2,2,2,2,2,2,2,2,1,1,1,1],

"it1":[541,541,545,551,0,542,551,0,551,0,541,548,0,
544,544,0,0,0,542,0,0,0,0,0,0,0,
0,0,0,0,0,0,0,0,0,542,0,425,0,
551,0,0,551,0,541,549,0,0,542,0,0,0,
0,0,540,0,0,547,0,541,0,0,542,0,0,
541,540,541,542,545,548,0,551,0,0,547,0,0,
548,0,549,0,0,547,0,0,0,0,0,0,0],

"it2":[0,403,0,0,0,0,0,0,0,0,0,0,0,
0,0,0,0,0,0,0,0,0,0,0,0,0,
0,0,0,0,0,0,0,0,0,4021,0,2021,0,
0,0,0,0,0,0,0,0,0,4021,0,0,0,
0,0,0,0,0,0,0,403,0,0,4021,0,0,
0,403,0,0,0,0,0,0,0,0,4021,4021,0,
0,0,0,0,0,0,0,0,0,0,0,0,0],

"point1": [[2,2],[8,2],[8,4],[9,4],[9,6],[12,6],[12,1],[10,1],[10,3],[11,3]],
"point2": [[2,2],[8,2],[8,4],[9,4],[9,6],[12,6],[12,1],[10,1],[10,3],[11,3]],

"jiaotuFlag":1,
"jiaotuTime":15000,
"jiaotuEft":["buff_jiaotu1","buff_jiaotu2","buff_jiaotu3","buff_jiaotu4"]

}
