{
"row":13,
"col":7,
"isloop":0,
"datas":[2,2,1,1,1,1,1,2,2,2,2,2,2,
2,2,1,2,2,2,1,2,2,2,2,2,2,
2,2,1,2,2,2,1,2,2,2,2,2,2,
2,2,1,2,2,2,1,2,2,2,2,2,2,
2,2,1,2,2,2,1,2,1,1,1,1,1,
2,2,1,2,2,2,1,1,1,2,2,2,1,
2,2,2,2,2,2,2,2,2,2,2,2,0],

"it1":[542,410,0,0,0,0,0,544,542,542,542,542,0,
542,542,0,551,0,542,0,0,541,542,542,549,0,
550,0,0,0,0,542,0,546,542,540,542,549,0,
0,0,0,542,542,542,0,0,542,549,0,548,0,
403,546,0,542,542,542,0,401,0,0,0,0,0,
542,0,0,540,540,542,0,0,0,551,0,544,0,
542,542,542,542,541,541,540,542,542,0,0,0,0],

"it2":[0,0,0,0,0,0,0,0,0,0,0,0,0,
0,0,0,7011,7011,0,0,0,0,0,0,0,0,
0,0,0,7011,7011,0,0,0,0,0,0,0,0,
0,0,0,0,0,0,0,0,0,0,0,0,0,
0,0,0,0,0,0,0,0,0,0,0,0,0,
0,0,0,0,0,0,0,0,0,7021,0,0,0,
0,0,0,0,0,0,0,0,0,7021,0,0,0],

"point1": [[2,5],[2,0],[6,0],[6,5],[8,5],[8,4],[12,4],[12,5]],
"point2": [[2,5],[2,0],[6,0],[6,5],[8,5],[8,4],[12,4],[12,5]],

"jiaotuFlag":1,
"jiaotuTime":15000,
"jiaotuEft":["buff_jiaotu1","buff_jiaotu2","buff_jiaotu3","buff_jiaotu4"]

}
