{
"row":13,
"col":7,
"isloop":0,
"datas":[2,2,2,1,1,1,1,1,1,1,1,1,1,
2,2,2,1,1,2,2,2,2,2,2,2,0,
2,2,2,2,1,1,2,2,2,2,2,2,2,
2,2,2,2,2,1,1,2,2,2,2,2,2,
2,2,2,2,2,2,1,1,2,2,2,2,2,
2,1,1,1,1,1,1,1,2,2,2,2,2,
2,2,2,2,2,2,2,2,2,2,2,2,2],

"it1":[544,545,410,0,0,0,0,0,0,0,0,0,0,
0,0,542,0,0,542,541,541,541,542,541,0,0,
544,540,541,542,0,0,542,401,542,547,0,541,541,
0,549,0,549,0,0,0,542,549,0,549,0,546,
542,401,542,540,541,542,0,0,549,0,549,0,0,
410,0,0,0,0,0,0,0,547,0,549,0,541,
541,548,0,549,0,542,547,0,548,0,542,541,542],

"it2":[0,0,0,0,0,0,0,0,0,0,0,0,0,
0,0,0,0,0,0,0,0,0,0,0,0,0,
0,0,0,0,0,0,0,0,0,0,0,0,0,
0,0,0,0,0,0,0,0,0,0,0,0,0,
0,0,0,0,0,0,0,0,0,0,0,0,0,
0,0,0,0,0,0,0,0,0,0,0,0,0,
0,0,0,0,0,0,0,0,0,0,0,0,6021],

"point1": [[1,5],[7,5],[7,4],[6,4],[6,3],[5,3],[5,2],[4,2],[4,1],[3,1],[3,0],[12,0]],
"point2": [[1,5],[7,5],[7,4],[6,4],[6,3],[5,3],[5,2],[4,2],[4,1],[3,1],[3,0],[12,0]],

"jiaotuFlag":1,
"jiaotuTime":15000,
"jiaotuEft":["buff_jiaotu1","buff_jiaotu2","buff_jiaotu3","buff_jiaotu4"]

}
