{
"row":13,
"col":7,
"isloop":0,
"datas":[2,2,2,2,2,2,2,2,2,2,2,2,2,
1,1,1,1,1,1,1,1,1,1,1,1,1,
2,2,2,2,2,2,1,2,2,2,2,2,0,
2,2,1,1,1,1,1,1,1,1,1,2,2,
2,2,2,2,2,2,1,2,2,2,1,2,2,
2,2,2,2,2,2,1,2,2,2,1,2,2,
2,2,2,2,2,2,1,1,1,1,1,2,2],

"it1":[540,541,542,547,0,547,0,548,0,549,0,540,0,
0,0,0,0,0,0,0,0,0,0,0,0,0,
541,542,547,0,548,0,0,547,0,548,0,545,0,
540,541,0,0,0,0,0,0,0,0,0,0,546,
541,544,545,546,550,0,0,546,406,0,0,542,0,
541,0,0,0,0,0,0,0,0,0,0,542,540,
541,540,541,542,547,0,0,0,0,0,0,411,541],

"it2":[],

"point1": [[2,3],[10,3],[10,6],[6,6],[6,1],[12,1]],
"point2": [[0,1],[12,1]],

"jiaotuFlag":1,
"jiaotuTime":15000,
"jiaotuEft":["buff_jiaotu1","buff_jiaotu2","buff_jiaotu3","buff_jiaotu4"]

}
