{
"row":13,
"col":7,
"isloop":0,
"datas":[2,2,2,2,2,2,2,2,2,2,2,2,2,
2,2,2,2,1,1,1,2,1,1,1,1,2,
2,2,2,2,1,2,1,2,1,2,2,0,2,
2,2,2,2,1,2,1,2,1,2,2,2,2,
2,2,2,2,1,2,1,2,1,2,2,2,2,
2,1,1,1,1,2,1,1,1,2,2,2,2,
2,2,2,2,2,2,2,2,2,2,2,2,2],

"it1":[541,544,551,0,548,0,549,0,541,0,547,0,541,
541,0,0,0,0,0,0,541,0,0,0,0,541,
541,544,551,0,0,545,0,546,0,551,0,0,546,
546,0,0,0,0,0,0,0,0,0,0,540,0,
0,542,547,0,0,541,0,542,0,549,0,545,541,
540,0,0,0,0,541,0,0,0,547,0,0,541,
540,540,541,542,540,541,542,541,542,547,0,541,541],

"it2":[0,0,0,0,0,0,0,0,0,0,0,0,0,
0,0,0,5031,0,0,0,0,0,0,0,0,0,
0,0,0,0,0,0,0,0,0,0,0,0,0,
0,0,0,5031,0,0,0,0,0,0,0,0,0,
0,0,0,0,0,0,0,0,0,0,0,0,0,
0,0,0,0,0,0,0,0,0,0,0,0,0,
0,0,0,0,0,0,0,0,0,0,0,0,0],

"point1": [[1,5],[4,5],[4,1],[6,1],[6,5],[8,5],[8,1],[11,1]],
"point2": [[1,5],[4,5],[4,1],[6,1],[6,5],[8,5],[8,1],[11,1]],
"point3": [[1,5],[4,5],[4,1],[6,1],[6,5],[8,5],[8,1],[11,1]],

"jiaotuFlag":1,
"jiaotuTime":15000,
"jiaotuEft":["buff_jiaotu1","buff_jiaotu2","buff_jiaotu3","buff_jiaotu4"]

}
