{
"row":13,
"col":7,
"isloop":0,
"datas":[2,2,2,2,2,1,1,1,1,1,1,1,1,
2,2,2,2,2,1,2,2,2,1,2,2,0,
2,2,2,2,2,1,2,2,2,1,2,2,2,
2,2,2,2,2,1,2,2,2,1,2,2,2,
2,2,2,1,1,1,1,1,1,1,2,2,2,
2,2,2,2,2,1,2,2,2,2,2,2,2,
2,2,2,2,2,1,2,2,2,2,2,2,2],

"it1":[547,0,544,541,0,0,0,0,0,0,0,0,0,
549,0,0,541,0,0,406,0,542,0,550,0,0,
541,542,540,541,542,0,0,0,541,0,0,0,546,
541,542,544,541,542,0,542,541,540,0,551,0,0,
541,542,0,0,0,0,0,0,0,0,0,0,542,
549,0,540,541,542,0,540,541,542,548,0,549,0,
540,540,540,542,542,0,541,540,541,542,547,0,541],

"it2":[],

"point1": [[5,6],[5,0],[12,0]],
"point2": [[5,6],[5,0],[12,0]],
"point3": [[3,4],[9,4],[9,0],[12,0]],
"point4": [[3,4],[9,4],[9,0],[12,0]],

"jiaotuFlag":1,
"jiaotuTime":15000,
"jiaotuEft":["buff_jiaotu1","buff_jiaotu2","buff_jiaotu3","buff_jiaotu4"]

}
