{
"row":13,
"col":7,
"isloop":0,
"iswood":1,
"datas":[2,2,2,4,4,4,4,4,4,4,1,1,1,
1,1,1,4,4,4,4,4,4,4,1,2,2,
2,2,1,4,4,4,4,4,4,4,1,2,2,
2,2,1,4,4,4,4,4,4,4,1,2,2,
2,2,1,4,4,2,2,2,4,4,1,2,2,
2,2,1,1,1,1,1,1,1,1,1,2,2,
2,2,4,4,4,4,0,4,4,4,4,2,2],

"it1":[621,622,621,0,0,0,0,0,0,0,0,0,0,
0,0,0,0,0,0,0,0,0,0,0,401,401,
623,623,0,0,0,0,0,0,0,0,0,406,0,
0,0,0,0,0,0,0,0,0,0,0,0,0,
621,0,0,0,0,401,401,401,0,0,0,401,401,
621,410,0,0,0,0,0,0,0,0,0,411,401,
620,621,0,0,0,0,0,0,0,0,0,401,401],

"it2":[],

"point1": [[0,1],[2,1],[2,5],[6,5]],
"point2": [[0,1],[2,1],[2,5],[6,5]],
"point3": [[12,0],[10,0],[10,5],[6,5]],
"point4": [[12,0],[10,0],[10,5],[6,5]]

}
