{
"row":13,
"col":7,
"isloop":0,
"datas":[2,2,2,2,2,2,2,2,1,1,1,1,1,
2,2,2,2,2,2,2,2,1,2,2,2,0,
2,2,2,2,2,2,2,2,1,2,2,2,2,
2,2,2,2,1,1,1,1,1,2,2,2,2,
2,2,2,2,1,2,2,2,2,2,2,2,2,
2,2,2,2,1,2,2,2,2,2,2,2,2,
1,1,1,1,1,2,2,2,2,2,2,2,2],

"it1":[540,540,0,547,0,540,540,542,0,0,0,0,0,
542,541,541,541,548,0,548,0,0,545,551,0,0,
401,542,542,542,542,549,0,401,0,0,0,0,541,
401,544,545,425,0,0,0,0,0,551,0,545,546,
541,0,0,541,0,545,551,0,541,0,0,0,0,
401,540,541,401,0,0,0,0,551,0,545,551,0,
0,0,0,0,0,548,0,541,0,0,0,0,0],

"it2":[0,0,0,0,0,0,0,0,0,0,0,0,0,
0,0,0,0,0,0,0,0,0,403,0,0,0,
0,0,0,0,0,0,0,0,0,0,0,0,0,
0,0,0,6021,0,0,0,0,0,0,0,0,0,
0,0,0,0,0,403,0,0,0,0,0,403,0,
0,0,0,0,0,0,0,0,0,0,0,0,0,
0,0,0,0,0,0,0,0,0,0,403,0,0],

"point1": [[0,6],[4,6],[4,3],[8,3],[8,0],[12,0]],
"point2": [[0,6],[4,6],[4,3],[8,3],[8,0],[12,0]],

"jiaotuFlag":1,
"jiaotuTime":15000,
"jiaotuEft":["buff_jiaotu1","buff_jiaotu2","buff_jiaotu3","buff_jiaotu4"]

}
