{
"row":13,
"col":7,
"isloop":0,
"datas":[2,2,2,2,2,2,2,2,2,1,1,1,2,
2,1,1,1,1,2,2,2,2,1,2,0,2,
2,2,2,2,1,1,2,2,2,1,2,2,2,
2,2,2,2,2,1,1,1,1,1,2,2,2,
2,2,2,2,1,1,2,2,2,1,2,2,2,
2,1,1,1,1,2,2,2,2,1,2,2,2,
2,2,2,2,2,2,2,2,2,1,2,2,2],

"it1":[541,541,542,547,0,551,0,547,0,0,0,0,545,
410,0,0,0,0,0,0,551,0,0,0,0,0,
551,0,401,401,0,0,540,0,0,0,540,541,541,
0,0,551,0,541,0,0,0,0,0,540,541,546,
547,0,0,0,0,0,546,551,0,0,541,542,0,
410,0,0,0,0,546,0,0,0,0,547,0,546,
540,540,542,548,0,0,548,0,542,0,549,0,0],

"it2":[0,1011,0,0,0,0,0,0,0,0,0,0,0,
0,0,0,0,0,0,0,0,0,0,0,0,0,
0,0,0,0,0,0,0,0,0,0,0,0,0,
0,0,0,0,0,0,0,0,0,0,0,0,0,
0,0,0,0,0,0,0,0,0,0,0,0,0,
0,0,0,0,0,0,0,0,0,0,0,0,0,
0,1011,0,0,0,0,0,0,0,0,0,0,0],

"point1": [[1,5],[4,5],[4,4],[5,4],[5,3],[9,3],[9,0],[11,0]],
"point2": [[1,1],[4,1],[4,2],[5,2],[5,3],[9,3],[9,0],[11,0]],
"point3": [[9,6],[9,3],[9,0],[11,0]],

"jiaotuFlag":1,
"jiaotuTime":15000,
"jiaotuEft":["buff_jiaotu1","buff_jiaotu2","buff_jiaotu3","buff_jiaotu4"]

}
