{
"row":13,
"col":7,
"isloop":0,
"datas":[2,2,2,1,1,1,2,2,2,2,2,2,2,
2,1,2,1,2,0,2,2,2,2,2,2,2,
2,1,2,1,2,2,2,2,2,2,2,2,2,
2,1,2,1,1,1,1,1,1,1,1,2,2,
2,1,2,2,2,2,2,2,2,2,1,2,2,
2,1,2,2,2,2,2,2,2,2,1,2,2,
2,1,1,1,1,1,1,1,1,1,1,2,2],

"it1":[549,0,542,0,0,0,0,542,542,542,551,0,546,
542,0,546,0,542,0,549,0,541,542,0,0,0,
541,0,0,0,549,0,549,0,549,0,541,542,542,
541,0,542,0,0,0,0,0,0,0,0,411,542,
401,0,551,0,542,549,0,549,0,404,0,404,546,
401,0,0,0,542,542,549,0,401,404,0,542,0,
410,0,0,0,0,0,0,0,0,0,0,401,542],

"it2":[0,0,0,0,0,0,0,0,0,0,0,0,0,
0,0,0,0,0,0,0,0,0,0,0,0,0,
0,0,0,0,0,0,0,0,0,0,0,0,0,
0,0,0,0,0,0,0,0,0,0,0,0,0,
0,0,0,0,0,0,0,0,0,1010,0,1010,0,
0,0,0,0,0,0,0,0,0,1010,0,0,0,
0,0,0,0,0,0,0,0,0,0,0,0,0],

"point1": [[1,1],[1,6],[10,6],[10,3],[3,3],[3,0],[5,0]],
"point2": [[1,1],[1,6],[10,6],[10,3],[3,3],[3,0],[5,0]],

"jiaotuFlag":1,
"jiaotuTime":15000,
"jiaotuEft":["buff_jiaotu1","buff_jiaotu2","buff_jiaotu3","buff_jiaotu4"]

}
