{
"row":13,
"col":7,
"isloop":0,
"datas":[2,2,2,2,2,2,2,2,2,2,2,2,2,
2,2,1,1,1,2,2,2,2,2,2,2,2,
2,2,1,2,1,2,2,2,2,2,2,2,2,
2,2,1,2,1,2,1,1,1,1,1,2,2,
2,2,1,2,1,2,1,2,2,2,2,2,2,
2,2,1,2,1,1,1,2,2,2,2,2,2,
2,2,0,2,2,2,2,2,2,2,2,2,2],

"it1":[540,541,547,0,548,0,542,540,541,542,546,550,0,
544,545,0,0,0,542,551,0,541,542,0,0,0,
0,0,0,544,0,401,0,0,548,0,0,551,0,
540,541,0,0,0,401,0,0,0,0,0,0,0,
551,0,0,540,0,542,0,546,551,0,541,542,546,
0,0,0,542,0,0,0,0,0,0,541,542,0,
540,540,0,540,549,0,541,541,541,547,0,548,0],

"it2":[],

"point1": [[10,3],[6,3],[6,5],[4,5],[4,1],[2,1],[2,5]],
"point2": [[10,3],[6,3],[6,5],[4,5],[4,1],[2,1],[2,5]],

"jiaotuFlag":1,
"jiaotuTime":15000,
"jiaotuEft":["buff_jiaotu1","buff_jiaotu2","buff_jiaotu3","buff_jiaotu4"]

}
