{
"row":13,
"col":7,
"isloop":1,
"datas":[4,2,4,2,4,2,4,2,4,2,4,2,4,
2,1,1,1,1,1,1,1,1,1,1,1,2,
4,1,2,4,2,4,2,4,2,4,2,1,4,
2,1,1,1,1,1,1,1,1,2,4,1,2,
4,2,4,4,2,4,4,2,1,4,2,1,4,
2,4,2,2,2,2,2,4,1,1,1,1,2,
4,2,4,4,2,4,4,2,4,2,4,2,4],

"it1":[0,540,0,542,0,540,0,401,0,540,0,542,0,
0,0,0,0,0,0,0,0,0,0,0,0,411,
0,0,541,0,404,0,540,0,540,0,404,0,0,
541,0,0,0,0,0,0,0,0,542,0,0,401,
0,541,0,0,542,0,0,542,0,0,540,0,0,
540,0,547,0,401,548,0,0,0,0,0,0,541,
0,540,0,0,542,0,0,401,0,540,0,540,0],

"it2":[0,0,0,0,0,0,0,0,0,0,0,0,0,
0,0,0,0,0,0,0,0,0,0,0,0,0,
0,0,0,0,1100,0,0,0,0,0,1100,0,0,
0,0,0,0,0,0,0,0,0,0,0,0,0,
0,0,0,0,0,0,0,0,0,0,0,0,0,
0,0,0,0,0,0,0,0,0,0,0,0,0,
0,0,0,0,0,0,0,0,0,0,0,0,0],

"point1":[[11,5],[11,1],[1,1],[1,3],[8,3],[8,5],[11,5]],

"jiaotuFlag":1,
"jiaotuTime":15000,
"jiaotuEft":["buff_jiaotu1","buff_jiaotu2","buff_jiaotu3","buff_jiaotu4"]

}
