{
"row":13,
"col":7,
"isloop":0,
"destroyed1":[[9,1],[8,1]],
"destroyed2":[[9,1],[8,1]],
"destroyed3":[[9,1],[8,1]],
"datas":[2,2,2,2,2,2,2,2,4,2,2,2,2,
4,4,2,4,2,2,4,4,1,2,2,4,4,
2,2,2,2,2,2,4,4,1,2,2,2,2,
4,2,4,4,2,4,2,2,1,4,4,2,4,
2,2,2,2,2,2,2,2,1,2,2,2,2,
1,1,1,1,1,1,1,1,1,2,2,2,2,
0,2,4,2,4,4,2,4,2,2,4,2,4],

"it1":[547,0,546,548,0,549,0,425,0,548,0,548,0,
0,0,0,0,546,401,0,0,0,400,0,0,0,
547,0,542,541,0,541,0,0,0,0,0,546,540,
0,544,0,0,540,0,549,0,0,0,0,0,0,
541,0,547,0,549,0,0,542,0,550,0,401,544,
0,0,0,0,0,0,0,0,0,0,0,545,0,
0,401,0,542,0,0,540,0,549,0,0,0,0],

"it2":[0,0,0,0,0,0,0,3031,0,0,0,0,0,
0,0,0,0,0,0,0,0,0,0,0,0,0,
0,0,0,0,0,0,0,0,0,0,0,0,0,
0,0,0,0,0,0,0,0,0,0,0,0,0,
0,0,0,0,0,0,0,0,0,3011,0,0,0,
0,0,0,0,0,0,0,0,0,0,0,0,0,
0,0,0,0,0,0,0,0,0,0,0,0,0],

"point1": [[8,1],[8,5],[0,5]],
"point2": [[8,1],[8,5],[0,5]],
"point3": [[8,1],[8,5],[0,5]],

"jiaotuFlag":1,
"jiaotuTime":15000,
"jiaotuEft":["buff_jiaotu1","buff_jiaotu2","buff_jiaotu3","buff_jiaotu4"]

}
