{
"row":13,
"col":7,
"isloop":0,
"datas":[4,2,2,2,4,2,2,1,1,1,2,2,4,
2,2,2,2,2,2,2,1,2,0,2,2,4,
2,4,4,2,4,2,2,1,1,1,1,1,1,
4,1,2,2,4,2,2,4,2,4,4,2,1,
2,1,2,2,2,2,2,2,4,2,1,1,1,
2,1,4,4,2,4,4,1,1,1,1,2,2,
2,1,1,1,1,1,1,1,4,4,2,2,2],

"it1":[0,550,0,401,0,548,0,0,0,0,406,0,0,
544,0,0,541,547,0,546,0,540,0,0,0,0,
0,0,0,545,0,546,0,0,0,0,0,0,0,
0,0,544,0,0,0,545,0,540,0,0,540,0,
425,0,0,425,545,542,0,540,0,540,0,0,0,
425,0,0,0,0,0,0,0,0,0,0,540,545,
401,0,0,0,0,0,0,0,0,0,542,0,0],

"it2":[0,0,0,0,0,0,0,0,0,0,0,0,0,
0,0,0,0,0,0,0,0,0,0,0,0,0,
0,0,0,0,0,0,0,0,0,0,0,0,0,
0,0,0,0,0,0,0,0,0,0,0,0,0,
7011,0,0,2041,0,0,0,0,0,0,0,0,0,
7011,0,0,0,0,0,0,0,0,0,0,0,0,
0,0,0,0,0,0,0,0,0,0,0,0,0],

"point1": [[1,3],[1,6],[7,6],[7,5],[10,5],[10,4],[12,4],[12,2],[7,2],[7,0],[9,0]],
"point2": [[1,3],[1,6],[7,6],[7,5],[10,5],[10,4],[12,4],[12,2],[7,2],[7,0],[9,0]],

"jiaotuFlag":1,
"jiaotuTime":15000,
"jiaotuEft":["buff_jiaotu1","buff_jiaotu2","buff_jiaotu3","buff_jiaotu4"]

}
