{
"row":13,
"col":7,
"isloop":0,
"datas":[2,1,1,1,1,1,1,1,1,1,1,1,2,
2,2,2,2,2,2,2,2,2,1,2,1,2,
2,1,1,1,1,1,1,1,1,1,2,0,2,
2,2,2,2,2,2,1,2,2,2,2,2,2,
2,1,1,1,1,1,1,2,2,2,2,2,2,
2,2,1,2,2,2,2,2,2,2,2,2,2,
1,1,1,2,2,2,2,2,2,2,2,2,2],

"it1":[410,0,0,0,0,0,0,0,0,0,0,0,540,
548,0,541,547,0,542,549,0,540,0,404,0,546,
410,0,0,0,0,0,0,0,0,0,6021,0,0,
549,0,542,549,0,401,0,550,0,546,540,541,544,
410,0,0,0,0,0,0,0,0,0,540,544,0,
548,0,0,551,0,545,540,542,546,551,0,0,401,
0,0,0,0,0,0,549,0,0,0,0,548,0],

"it2":[0,0,0,0,0,0,0,0,0,0,0,0,0,
0,0,0,0,0,0,0,0,0,0,1370,0,0,
0,0,0,0,0,0,0,0,0,0,0,0,0,
0,0,0,0,0,0,0,0,0,0,0,0,0,
0,0,0,0,0,0,0,0,0,0,0,0,0,
0,0,0,0,0,0,0,0,0,0,0,0,0,
0,0,0,0,0,0,0,0,0,0,0,0,0],

"point1": [[0,6],[2,6],[2,4],[6,4],[6,2],[9,2],[9,0],[11,0],[11,1]],
"point2": [[1,4],[6,4],[6,2],[9,2],[9,0],[11,0],[11,1]],
"point3": [[1,2],[9,2],[9,0],[11,0],[11,1]],
"point4": [[1,0],[11,0],[11,1]],

"jiaotuFlag":1,
"jiaotuTime":15000,
"jiaotuEft":["buff_jiaotu1","buff_jiaotu2","buff_jiaotu3","buff_jiaotu4"]

}
