{
"row":13,
"col":7,
"isloop":0,
"datas":[2,1,3,3,3,3,3,3,3,3,3,3,3,
2,2,2,2,2,2,2,2,2,2,2,2,3,
2,2,3,2,2,3,2,2,3,2,2,3,3,
4,2,4,4,2,4,4,2,4,4,2,4,3,
3,3,2,2,2,2,2,2,2,2,2,2,3,
1,3,3,2,2,3,2,2,3,2,2,3,3,
0,3,3,3,3,3,3,3,3,3,3,3,2],

"it1":[410,0,0,0,0,0,0,0,0,0,0,0,0,
551,0,404,550,0,404,551,0,404,550,0,404,0,
0,0,0,0,0,0,0,0,0,0,0,0,0,
0,401,0,0,401,0,0,401,0,0,401,0,0,
0,0,404,551,0,404,550,0,404,551,0,404,0,
0,0,0,0,0,0,0,0,0,0,0,0,0,
0,0,0,0,0,0,0,0,0,0,0,0,411],

"it2":[0,0,0,0,0,0,0,0,0,0,0,0,0,
0,0,1100,0,0,1100,0,0,1100,0,0,1100,0,
0,0,0,0,0,0,0,0,0,0,0,0,0,
0,0,0,0,0,0,0,0,0,0,0,0,0,
0,0,1100,0,0,1100,0,0,1100,0,0,1100,0,
0,0,0,0,0,0,0,0,0,0,0,0,0,
0,0,0,0,0,0,0,0,0,0,0,0,0],

"point1": [[1,0],[0,5]],
"point2": [[1,0],[0,5]],

"jiaotuFlag":1,
"jiaotuTime":15000,
"jiaotuEft":["buff_jiaotu1","buff_jiaotu2","buff_jiaotu3","buff_jiaotu4"]

}
