{
"row":13,
"col":7,
"isloop":0,
"iswood":1,
"datas":[1,2,2,2,2,2,2,2,2,2,2,2,1,
1,2,2,2,2,2,4,2,2,2,2,1,1,
1,4,2,2,2,2,4,2,2,2,1,1,2,
1,1,1,1,1,1,1,1,1,1,1,2,4,
1,2,2,2,2,2,4,2,2,0,1,1,2,
1,2,2,2,2,2,2,2,2,2,2,1,1,
1,2,2,2,2,2,2,2,2,2,2,2,1],

"it1":[0,621,623,624,625,401,631,0,622,628,0,620,0,
0,621,0,0,0,622,0,629,0,624,401,0,0,
0,0,620,0,622,622,0,0,0,0,0,0,622,
0,0,0,0,0,0,0,0,0,0,0,622,0,
0,621,622,629,0,625,0,629,0,0,0,0,622,
0,626,0,0,0,0,620,0,0,622,401,0,0,
0,620,620,620,621,401,628,0,628,0,628,0,0],

"it2":[0,0,0,0,0,0,0,0,0,0,0,0,0,
0,0,0,0,0,0,0,0,0,0,0,0,0,
0,0,0,0,0,0,0,0,0,0,0,0,4021,
0,0,0,0,0,0,0,0,0,0,0,4021,0,
0,0,0,0,0,0,0,0,0,0,0,0,4021,
0,0,0,0,0,0,0,0,0,0,0,0,0,
0,0,0,0,0,0,0,0,0,0,0,0,0],

"point1": [[0,3],[9,3]],
"point2": [[0,6],[0,3],[9,3]],
"point3": [[0,0],[0,3],[9,3]],
"point4": [[12,6],[12,5],[11,5],[11,4],[10,4],[10,3],[9,3]],
"point5": [[12,0],[12,1],[11,1],[11,2],[10,2],[10,3],[9,3]]

}
