{
"row":13,
"col":7,
"isloop":0,
"datas":[2,2,2,2,2,2,2,2,2,2,2,2,2,
2,2,1,1,1,1,1,1,1,1,2,2,2,
2,2,1,2,2,2,2,2,2,1,2,2,2,
2,2,1,1,1,1,2,2,2,1,2,2,2,
2,2,2,2,2,0,2,2,2,1,2,2,2,
2,2,1,1,1,1,1,1,1,1,2,2,2,
2,2,2,2,2,2,2,2,2,2,2,2,2],

"it1":[582,581,580,581,581,582,586,0,588,0,582,582,401,
581,581,0,0,0,0,0,0,0,0,590,0,582,
590,0,0,580,588,0,590,0,585,0,0,0,582,
0,0,0,0,0,0,0,0,0,0,0,586,0,
401,581,588,0,401,0,587,0,582,0,582,582,582,
582,584,0,0,0,0,0,0,0,0,581,582,582,
580,0,582,581,582,580,582,581,581,582,582,586,0],

"it2":[0,0,0,0,0,0,0,0,0,1021,0,0,0,
0,0,0,0,0,0,0,0,0,0,0,0,0,
0,0,0,0,0,1021,0,0,0,0,0,0,0,
0,0,0,0,0,0,0,0,0,0,0,0,0,
0,0,1021,0,0,0,0,0,0,0,0,0,0,
0,0,0,0,0,0,0,0,0,0,0,0,0,
0,0,0,0,0,0,0,0,0,0,0,0,0],

"point1": [[2,5],[9,5],[9,1],[2,1],[2,3],[5,3]],
"point2": [[2,5],[9,5],[9,1],[2,1],[2,3],[5,3]],

"sandRate":25,
"delAttackDis":25

}
