{
"row":13,
"col":7,
"isloop":0,
"datas":[2,2,2,2,2,2,2,2,2,1,1,1,2,
2,2,2,2,2,2,2,2,2,1,2,1,2,
2,2,1,1,1,1,1,1,1,1,1,1,2,
2,2,1,2,2,2,2,2,2,1,2,0,2,
1,1,1,1,1,1,1,1,1,1,2,2,2,
2,2,1,2,2,2,2,2,2,2,2,2,2,
2,2,1,2,2,2,2,2,2,2,2,2,2],

"it1":[590,0,589,0,401,586,0,585,582,0,0,0,583,
0,0,0,0,588,0,581,0,581,0,412,0,0,
585,583,0,0,0,0,0,0,0,0,0,0,401,
0,0,0,0,588,0,404,588,0,0,0,0,584,
0,0,0,0,0,0,0,0,0,0,406,0,0,
580,580,0,588,0,589,0,586,0,583,0,0,583,
586,0,0,586,0,0,0,582,580,0,581,580,0],

"it2":[0,0,0,0,0,0,0,0,0,0,0,0,0,
0,0,0,0,0,0,0,0,0,0,0,0,0,
0,0,0,0,0,0,0,0,0,0,0,0,0,
0,0,0,0,0,0,1370,0,0,0,0,0,0,
0,0,0,0,0,0,0,0,0,0,0,0,0,
0,0,0,0,0,0,0,0,0,0,0,0,0,
0,0,0,0,0,0,0,0,0,0,0,0,0],

"sandwave":[1,2,3,4,5,6,7,8,9,10,11,12,13,14,15,16,17,18,19,20,21,22,23,24,25,26,27,28,29,30],
"sandhole1":[[3,3],[4,3],[5,3],[6,3],[7,3],[8,3]],

"point1": [[2,6],[2,2],[11,2]],
"point2": [[2,6],[2,2],[11,2]],
"point3": [[0,4],[9,4],[9,0],[11,0],[11,2]],
"point4": [[0,4],[9,4],[9,0],[11,0],[11,2]],

"sandRate":25,
"delAttackDis":25

}
