{
"row":13,
"col":7,
"isloop":0,
"datas":[2,2,2,2,2,2,2,2,2,2,2,2,2,
2,1,1,1,1,1,1,1,1,1,1,1,2,
2,1,2,2,2,2,2,2,2,2,2,1,2,
2,1,2,2,2,2,2,2,2,2,2,1,2,
2,1,2,2,2,2,2,2,2,2,2,1,2,
2,1,2,2,2,2,2,2,2,2,2,1,2,
2,2,2,2,2,2,2,2,2,2,2,0,2],

"it1":[401,588,0,582,586,0,580,586,0,582,588,0,580,
410,0,0,0,0,0,0,0,0,0,0,0,585,
580,0,590,0,401,403,412,403,401,590,0,0,0,
585,0,0,0,580,404,403,404,580,0,0,0,580,
0,0,590,0,580,404,403,404,580,590,0,0,585,
401,0,0,0,580,403,412,403,580,0,0,0,0,
588,0,587,0,580,580,580,580,580,587,0,0,0],

"it2":[0,0,0,0,0,0,0,0,0,0,0,0,0,
0,0,0,0,0,0,0,0,0,0,0,0,0,
0,0,0,0,0,0,0,0,0,0,0,0,0,
0,0,0,0,0,1270,0,1270,0,0,0,0,0,
0,0,0,0,0,1270,0,1270,0,0,0,0,0,
0,0,0,0,0,0,0,0,0,0,0,0,0,
0,0,0,0,0,0,0,0,0,0,0,0,0],

"sandwave":[1,2,3,4,5,6,7,8,9,10,11,12,13,14,15,16,17,18,19,20,21,22,23,24,25,26,27,28,29,30],
"sandhole1":[[2,4],[5,4]],
"sandhole2":[[2,3],[5,3]],
"sandhole3":[[7,4],[10,4]],
"sandhole4":[[7,3],[10,3]],
"sandhole5":[[2,2],[4,2]],
"sandhole6":[[8,2],[10,2]],

"point1": [[1,5],[1,1],[11,1],[11,5]],
"point2": [[1,5],[1,1],[11,1],[11,5]],
"point3": [[1,5],[1,1],[11,1],[11,5]],

"sandRate":25,
"delAttackDis":25

}
