{
"row":13,
"col":7,
"isloop":0,
"datas":[1,1,1,1,1,1,1,1,1,1,1,1,1,
1,2,2,1,1,2,1,2,1,1,2,2,1,
1,2,2,1,1,2,1,2,1,1,2,2,1,
1,2,1,1,1,1,1,1,1,1,1,2,1,
2,2,1,2,2,1,1,1,2,2,1,2,2,
2,2,1,2,2,1,1,1,2,2,1,2,2,
2,2,1,1,1,1,0,1,1,1,1,2,2],

"it1":[0,0,0,0,0,0,0,0,0,0,0,0,0,
0,434,0,0,0,423,0,423,0,0,434,0,0,
0,0,0,0,0,427,0,0,0,0,0,0,0,
0,430,0,0,0,0,0,0,0,0,0,430,0,
431,0,0,433,0,0,0,0,433,0,0,0,431,
0,423,0,0,0,0,0,0,0,0,0,423,0,
429,0,0,0,0,0,0,0,0,0,0,429,0],

"it2":[0,0,0,0,0,0,0,0,0,0,0,0,0,
0,0,0,0,0,0,0,0,0,0,0,0,0,
0,0,0,0,0,0,0,0,0,0,0,0,0,
0,1021,0,0,0,0,0,0,0,0,0,1021,0,
0,0,0,0,0,0,0,0,0,0,0,0,0,
0,0,0,0,0,0,0,0,0,0,0,0,0,
0,0,0,0,0,0,0,0,0,0,0,0,0],

"point1": [[0,3],[0,0],[3,0],[3,3],[2,3],[2,6],[5,6],[5,3],[4,3],[4,0],[6,0],[6,5]],
"point2": [[0,3],[0,0],[3,0],[3,3],[2,3],[2,6],[5,6],[5,3],[4,3],[4,0],[6,0],[6,5]],
"point3": [[12,3],[12,0],[9,0],[9,3],[10,3],[10,6],[7,6],[7,3],[8,3],[8,0],[6,0],[6,5]],
"point4": [[12,3],[12,0],[9,0],[9,3],[10,3],[10,6],[7,6],[7,3],[8,3],[8,0],[6,0],[6,5]]

}
