{
"row":13,
"col":7,
"isloop":0,
"datas":[1,1,1,1,2,1,1,1,1,1,1,1,1,
1,2,2,1,2,1,1,1,1,1,1,1,1,
1,2,2,1,2,1,0,2,2,2,2,1,1,
1,2,2,1,2,1,1,1,1,1,1,1,1,
1,2,2,1,2,2,2,2,2,2,2,2,1,
1,2,2,1,1,1,1,1,1,1,1,1,1,
1,2,2,1,2,2,2,2,2,2,2,2,2],

"it1":[0,0,0,0,401,0,0,0,0,0,0,0,0,
0,585,0,0,582,0,0,0,0,0,0,0,0,
0,0,580,0,584,0,0,580,588,0,582,0,0,
0,590,0,0,0,0,0,0,0,0,0,0,0,
0,0,0,0,586,0,401,587,0,401,588,0,0,
0,401,410,0,0,0,0,0,0,0,0,0,0,
0,586,0,0,581,587,0,581,588,0,582,587,0],

"it2":[0,0,0,0,0,0,0,0,0,0,0,0,0,
0,0,0,0,0,0,0,0,0,0,0,0,0,
0,0,0,0,0,0,0,0,0,0,412,0,0,
0,0,0,0,0,0,0,0,0,0,0,0,0,
0,0,412,0,412,0,0,0,0,0,0,412,0,
0,0,0,0,0,0,0,0,0,0,0,0,0,
0,0,0,0,0,0,0,0,0,0,0,0,0],

"point1": [[0,6],[0,0],[3,0],[3,5],[12,5],[12,0],[5,0],[5,3],[11,3],[11,1],[6,1]],
"point2": [[0,6],[0,0],[3,0],[3,5],[12,5],[12,0],[5,0],[5,3],[11,3],[11,1],[6,1]],
"point3": [[3,6],[3,5],[12,5],[12,0],[5,0],[5,3],[11,3],[11,1],[6,1]],
"point4": [[3,6],[3,5],[12,5],[12,0],[5,0],[5,3],[11,3],[11,1],[6,1]],

"sandRate":25,
"delAttackDis":25

}
