{
"row":13,
"col":7,
"isloop":0,
"iswood":1,
"datas":[2,2,2,1,1,1,1,1,1,1,2,2,2,
2,2,2,1,2,4,4,4,2,1,2,2,2,
2,2,2,1,4,4,2,4,4,1,2,2,2,
1,1,1,1,1,1,1,1,1,1,1,1,1,
2,2,2,1,4,4,2,4,4,1,2,2,0,
2,2,2,1,2,4,4,4,2,1,2,2,2,
2,2,2,1,1,1,1,1,1,1,2,2,2],

"it1":[623,624,410,0,0,0,0,0,0,0,412,412,412,
0,0,622,0,401,0,0,0,401,0,412,425,412,
620,621,0,0,0,0,622,0,0,0,412,412,412,
0,0,0,0,0,0,0,0,0,0,0,0,0,
623,620,625,0,0,0,622,0,0,0,412,412,0,
0,622,0,0,401,0,0,0,401,0,412,425,412,
620,621,410,0,0,0,0,0,0,0,412,412,412],

"it2":[0,0,0,0,0,0,0,0,0,0,0,0,0,
0,0,0,0,0,0,0,0,0,0,0,5041,0,
0,0,0,0,0,0,0,0,0,0,0,0,0,
0,0,0,0,0,0,0,0,0,0,0,0,0,
0,0,0,0,0,0,0,0,0,0,0,0,0,
0,0,0,0,0,0,0,0,0,0,0,5041,0,
0,0,0,0,0,0,0,0,0,0,0,0,0],

"point1": [[0,3],[3,3],[3,6],[9,6],[9,3],[12,3]],
"point2": [[0,3],[3,3],[3,6],[9,6],[9,3],[12,3]],
"point3": [[0,3],[3,3],[3,0],[9,0],[9,3],[12,3]],
"point4": [[0,3],[3,3],[3,0],[9,0],[9,3],[12,3]],
"point5": [[0,3],[12,3]]

}
