{
"row":13,
"col":7,
"isloop":0,
"iswood":1,
"datas":[2,2,2,2,2,2,2,2,2,2,1,2,2,
2,2,2,2,2,2,1,1,1,1,1,2,2,
2,2,2,4,4,4,1,2,2,2,2,2,2,
2,1,1,1,1,1,1,1,1,1,1,1,1,
2,2,4,2,2,2,1,2,2,2,2,2,0,
2,2,4,2,2,2,1,1,1,1,1,2,2,
2,2,2,2,2,2,2,2,2,2,1,2,2],

"it1":[621,620,621,621,629,0,620,425,627,0,0,621,622,
622,622,622,622,0,0,0,0,0,0,0,621,622,
620,0,622,0,0,0,0,621,620,621,622,626,0,
620,0,0,0,0,0,0,0,0,0,0,0,0,
623,623,0,625,624,625,0,620,621,622,626,0,0,
0,0,0,0,0,0,0,0,0,0,0,406,0,
620,620,621,622,621,622,621,622,620,425,0,0,0],

"it2":[0,0,0,0,0,0,0,1011,0,0,0,0,0,
0,0,0,0,0,0,0,0,0,0,0,0,0,
0,0,0,0,0,0,0,0,0,0,0,0,0,
0,0,0,0,0,0,0,0,0,0,0,0,0,
0,0,0,0,0,0,0,0,0,0,0,0,0,
0,0,0,0,0,0,0,0,0,0,0,0,0,
0,0,0,0,0,0,0,0,0,1011,0,0,0],

"point1": [[1,3],[6,3],[12,3]],
"point2": [[10,6],[10,5],[6,5],[6,3],[12,3]],
"point3": [[10,0],[10,1],[6,1],[6,3],[12,3]],

"fogRate":25,
"delAttackSpeed":25

}
