{
"row":13,
"col":7,
"isloop":0,
"iswood":1,
"datas":[2,1,2,2,2,2,1,2,2,2,2,1,2,
2,1,2,4,2,2,1,2,2,4,2,1,2,
2,1,2,4,2,2,1,2,2,4,2,1,2,
2,1,1,1,1,1,1,1,1,1,1,1,2,
2,1,2,4,2,2,1,2,2,4,2,1,2,
2,1,2,4,2,2,1,2,2,4,2,1,2,
2,1,2,2,2,2,0,2,2,2,2,1,2],

"it1":[0,0,627,0,621,620,0,620,621,626,0,0,621,
622,0,623,0,630,0,0,630,0,0,401,0,622,
0,0,0,0,0,0,0,0,0,0,622,0,622,
620,0,0,0,0,0,0,0,0,0,0,0,620,
623,0,623,0,630,0,0,630,0,0,622,0,622,
0,0,0,0,0,0,0,0,0,0,401,0,622,
620,0,627,0,425,620,0,620,425,627,0,0,621],

"it2":[0,0,0,0,0,0,0,0,0,0,0,0,0,
0,0,0,0,0,0,0,0,0,0,0,0,0,
0,0,0,0,0,0,0,0,0,0,0,0,0,
0,0,0,0,0,0,0,0,0,0,0,0,0,
0,0,0,0,0,0,0,0,0,0,0,0,0,
0,0,0,0,0,0,0,0,0,0,0,0,0,
0,0,0,0,1041,0,0,0,1041,0,0,0,0],

"point1": [[1,6],[1,3],[6,3],[6,5]],
"point2": [[11,6],[11,3],[6,3],[6,5]],
"point3": [[1,0],[1,3],[6,3],[6,5]],
"point4": [[11,0],[11,3],[6,3],[6,5]],
"point5": [[6,0],[6,5]],

"fogRate":25,
"delAttackSpeed":25

}
