{
"row":13,
"col":7,
"isloop":0,
"iswood":1,
"datas":[2,1,2,2,2,2,2,2,2,2,2,2,2,
2,1,2,2,2,1,1,1,1,1,1,1,1,
2,1,2,2,2,1,2,2,2,2,4,2,2,
2,1,1,1,1,1,2,2,4,2,2,2,2,
2,2,2,2,2,1,1,1,1,1,2,2,2,
2,2,2,2,2,1,2,4,2,2,2,2,2,
2,2,4,4,2,0,2,2,2,2,2,2,2],

"it1":[0,0,620,628,0,628,0,620,621,401,621,622,622,
622,0,629,0,625,0,0,0,0,0,0,0,0,
622,0,0,0,0,0,406,0,621,621,0,622,625,
625,0,0,0,0,0,0,0,0,620,622,622,0,
0,622,624,629,0,0,0,0,0,0,625,625,622,
628,0,0,0,0,0,401,0,401,622,0,0,0,
622,620,0,0,622,0,401,628,0,626,0,621,622],

"it2":[],

"point1": [[1,0],[1,3],[5,3],[5,5]],
"point2": [[1,0],[1,3],[5,3],[5,5]],
"point3": [[12,1],[5,1],[5,5]],
"point4": [[12,1],[5,1],[5,5]],
"point5": [[9,4],[5,4],[5,5]],

"fogRate":25,
"delAttackSpeed":25

}
