{
"row":13,
"col":7,
"isloop":0,
"iswood":1,
"datas":[1,1,1,1,1,2,2,2,2,2,1,1,1,
1,2,2,2,1,2,2,4,4,1,1,2,2,
1,2,2,2,1,1,1,2,1,1,2,2,2,
2,2,4,4,2,2,1,1,1,2,2,2,2,
1,2,2,2,1,1,1,0,1,1,2,2,2,
1,2,2,2,1,4,4,2,2,1,1,2,2,
1,1,1,1,1,2,2,2,2,2,1,1,1],

"it1":[0,0,0,0,0,624,624,631,0,401,0,0,0,
0,620,631,0,0,0,0,0,0,0,0,630,0,
0,622,622,621,0,0,0,412,0,0,401,0,0,
621,0,0,0,401,412,0,0,0,412,630,0,625,
0,622,622,622,0,0,0,0,0,0,0,0,0,
0,631,0,403,0,0,0,412,401,0,0,631,0,
0,0,0,0,0,626,0,626,0,401,0,0,0],

"it2":[0,0,0,0,0,0,0,0,0,0,0,0,0,
0,0,0,0,0,0,0,0,0,0,0,1021,0,
0,0,0,0,0,0,0,0,0,0,0,1021,0,
0,0,0,0,0,0,0,0,0,0,1021,0,0,
0,0,0,0,0,0,0,0,0,0,1021,0,0,
0,0,0,0,0,0,0,0,0,0,0,0,0,
0,0,0,0,0,0,0,0,0,0,0,0,0],

"point1": [[0,4],[0,6],[4,6],[4,4],[6,4],[6,3],[7,3]],
"point2": [[0,2],[0,0],[4,0],[4,2],[6,2],[6,3],[7,3]],
"point3": [[12,6],[10,6],[10,5],[9,5],[9,4],[8,4],[8,3],[7,3]],
"point4": [[12,0],[10,0],[10,1],[9,1],[9,2],[8,2],[8,3],[7,3]],

"fogRate":25,
"delAttackSpeed":25

}
