{
"row":13,
"col":7,
"isloop":0,
"iswood":1,
"datas":[2,2,2,2,2,2,2,2,2,2,2,3,2,
2,2,2,4,2,2,2,4,2,2,2,4,2,
3,3,3,3,3,3,3,3,3,3,3,3,1,
3,4,2,2,2,4,2,2,2,4,2,2,0,
1,2,2,2,2,2,2,2,2,2,2,2,2,
2,2,2,4,2,2,2,4,2,2,2,4,2,
2,2,2,2,2,2,2,2,2,2,2,2,2],

"it1":[401,621,621,621,621,621,621,621,621,621,621,0,624,
621,621,621,0,621,621,621,0,621,621,621,0,0,
0,0,0,0,0,0,0,0,0,0,0,0,0,
0,0,621,621,620,0,621,621,621,0,621,624,0,
0,621,621,621,621,621,621,621,621,621,621,0,624,
621,403,621,0,621,403,621,0,621,403,621,0,0,
621,621,621,621,621,621,621,621,621,621,621,621,621],

"it2":[],

"point1": [[0,4],[12,2]],
"point2": [[0,4],[12,2]],

"fogRate":25,
"delAttackSpeed":25

}
