{
"row":13,
"col":7,
"isloop":0,
"iswood":1,
"datas":[2,2,2,2,2,2,2,2,2,2,2,2,2,
2,2,1,1,1,2,1,1,1,2,1,1,1,
2,2,1,4,1,2,1,4,1,2,1,4,1,
1,1,1,1,1,1,1,1,1,1,1,1,1,
2,2,1,2,1,4,1,2,1,4,1,2,0,
2,2,1,2,1,1,1,2,1,1,1,2,2,
2,2,2,2,2,2,2,2,2,2,2,2,2],

"it1":[620,621,622,627,0,628,0,620,622,628,0,628,0,
623,410,0,0,0,410,0,0,0,410,0,0,0,
0,622,0,0,0,404,0,0,0,404,0,0,0,
0,0,0,0,0,0,0,0,0,0,0,0,0,
630,0,0,404,0,0,0,404,0,0,0,622,0,
0,0,0,410,0,0,0,410,0,0,0,406,0,
621,0,628,0,626,0,621,621,622,622,622,0,0],

"it2":[0,0,0,0,0,0,0,0,0,0,0,0,0,
0,0,0,0,0,0,0,0,0,0,0,0,0,
0,0,0,0,0,1050,0,0,0,1050,0,0,0,
0,0,0,0,0,0,0,0,0,0,0,0,0,
0,0,0,1050,0,0,0,1050,0,0,0,0,0,
0,0,0,0,0,0,0,0,0,0,0,0,0,
0,0,0,0,0,0,0,0,0,0,0,0,0],

"point1": [[0,3],[12,3]],
"point2": [[0,3],[12,3]],
"point3": [[2,5],[2,1],[4,1],[4,5],[6,5],[6,1],[8,1],[8,5],[10,5],[10,1],[12,1],[12,3]],
"point4": [[2,5],[2,1],[4,1],[4,5],[6,5],[6,1],[8,1],[8,5],[10,5],[10,1],[12,1],[12,3]],

"fogRate":25,
"delAttackSpeed":25

}
