{
"row":13,
"col":7,
"isloop":0,
"iswood":1,
"datas":[2,1,1,1,1,2,2,2,2,2,2,2,2,
2,2,2,2,1,2,2,2,2,2,2,2,2,
2,2,2,2,1,2,2,2,2,2,2,2,2,
2,2,1,1,1,1,1,1,1,1,1,1,1,
2,2,2,2,1,2,2,2,2,2,2,2,0,
2,2,2,2,1,2,2,2,2,2,2,2,2,
2,1,1,1,1,2,2,2,2,2,2,2,2],

"it1":[410,0,0,0,0,620,621,622,626,0,627,0,620,
628,0,413,0,0,620,0,622,626,0,629,0,620,
626,0,0,0,0,622,622,622,626,0,0,0,620,
401,410,0,0,0,0,0,0,0,0,0,0,0,
621,622,406,0,0,623,624,625,629,0,401,401,0,
621,622,0,0,0,0,0,0,0,0,401,401,620,
410,0,0,0,0,620,621,622,626,0,627,0,620],

"it2":[0,0,0,0,0,0,0,0,0,0,0,0,0,
0,0,0,0,0,0,0,0,0,0,0,0,0,
0,0,0,0,0,0,0,0,0,0,0,0,0,
0,0,0,0,0,0,0,0,0,0,0,0,0,
0,0,0,0,0,0,0,0,0,0,0,1010,0,
0,0,0,0,0,0,0,0,0,0,0,0,0,
0,0,0,0,0,0,0,0,0,0,0,0,0],

"point1": [[1,6],[4,6],[4,3],[12,3]],
"point2": [[1,6],[4,6],[4,3],[12,3]],
"point3": [[2,3],[12,3]],
"point4": [[1,0],[4,0],[4,3],[12,3]],
"point5": [[1,0],[4,0],[4,3],[12,3]],

"fogRate":25,
"delAttackSpeed":25

}
