{
"row":13,
"col":7,
"isloop":0,
"iswood":1,
"datas":[2,2,2,2,2,2,2,2,2,2,1,1,1,
2,2,2,2,2,2,4,2,2,2,0,2,1,
2,2,2,2,4,2,2,2,1,1,1,1,1,
2,2,2,2,2,2,2,2,1,2,2,2,2,
2,2,2,2,2,2,2,2,1,2,2,2,2,
2,1,1,1,1,1,1,1,1,2,2,2,2,
2,2,2,2,2,2,2,2,2,4,2,2,2],

"it1":[0,622,622,621,621,622,622,621,406,0,0,0,0,
622,630,0,622,621,622,0,622,0,0,0,622,0,
625,0,0,620,0,621,621,410,0,0,0,0,0,
0,625,630,0,630,0,630,0,0,401,401,626,0,
622,0,0,0,0,0,0,0,0,630,0,624,625,
410,0,0,0,0,0,0,0,0,0,0,0,0,
620,621,622,621,627,0,620,622,620,0,403,620,622],

"it2":[],

"point1": [[1,5],[8,5],[8,2],[12,2],[12,0],[10,0]],
"point2": [[1,5],[8,5],[8,2],[12,2],[12,0],[10,0]],
"point3": [[1,5],[8,5],[8,2],[12,2],[12,0],[10,0]],

"fogRate":25,
"delAttackSpeed":25

}
