{
"row":13,
"col":7,
"isloop":0,
"iswood":1,
"datas":[1,1,1,1,2,2,2,2,2,2,2,2,2,
2,2,2,1,2,2,2,1,1,1,1,1,1,
2,2,2,1,1,2,2,1,2,2,2,2,2,
2,2,2,2,1,1,1,1,1,1,1,1,1,
2,2,2,2,2,2,2,1,2,2,2,1,0,
2,2,2,2,2,2,2,1,1,1,1,1,2,
2,2,2,2,2,2,2,2,2,2,2,2,2],

"it1":[0,0,0,0,624,406,0,0,622,626,0,620,621,
623,624,625,0,0,0,0,0,0,0,0,0,0,
0,0,0,0,0,621,622,0,627,0,628,0,622,
623,621,620,410,0,0,0,0,0,0,0,0,0,
0,621,623,406,0,625,621,0,622,620,622,0,0,
620,621,0,0,0,0,410,0,0,0,0,0,622,
0,622,620,621,622,622,627,0,620,621,622,621,622],

"it2":[],

"point1": [[0,0],[3,0],[3,2],[4,2],[4,3],[12,3]],
"point2": [[0,0],[3,0],[3,2],[4,2],[4,3],[12,3]],
"point3": [[12,1],[7,1],[7,5],[11,5],[11,3],[12,3]],
"point4": [[12,1],[7,1],[7,5],[11,5],[11,3],[12,3]],

"fogRate":25,
"delAttackSpeed":25

}
