{
"row":13,
"col":7,
"isloop":0,
"iswood":1,
"datas":[2,1,1,1,1,2,2,2,2,2,2,2,2,
2,1,2,2,1,1,1,1,1,1,2,2,2,
2,1,2,2,2,2,2,2,2,1,1,1,2,
2,1,1,1,1,1,1,1,1,1,1,1,1,
2,1,2,2,2,2,2,2,2,1,1,1,0,
2,1,2,2,1,1,1,1,1,1,2,2,2,
2,1,1,1,1,2,2,2,2,2,2,2,2],

"it1":[410,0,0,0,0,622,627,0,628,0,622,625,0,
401,0,625,410,0,0,0,0,0,0,412,0,0,
401,0,0,401,627,0,401,627,0,0,0,0,412,
410,0,0,0,0,0,0,0,0,0,0,0,0,
401,0,625,401,401,627,0,627,0,0,0,0,0,
401,0,0,410,0,0,0,0,0,0,628,0,412,
410,0,0,0,0,620,627,0,622,628,0,628,0],

"it2":[0,0,0,0,0,0,0,0,0,0,0,0,0,
0,0,0,0,0,0,0,0,0,0,0,0,0,
0,0,0,0,0,0,0,0,0,0,0,0,0,
0,0,0,0,0,0,0,0,0,0,0,0,0,
0,0,0,0,0,0,0,0,0,0,0,0,0,
0,0,0,0,0,0,0,0,0,0,0,0,0,
0,0,0,0,0,0,0,0,0,0,0,0,0],

"point1": [[1,3],[12,3]],
"point2": [[1,3],[1,6],[4,6],[4,5],[9,5],[9,4],[11,4],[11,3],[12,3]],
"point3": [[1,3],[1,6],[4,6],[4,5],[9,5],[9,4],[11,4],[11,3],[12,3]],
"point4": [[1,3],[1,0],[4,0],[4,1],[9,1],[9,2],[11,2],[11,3],[12,3]],
"point5": [[1,3],[1,0],[4,0],[4,1],[9,1],[9,2],[11,2],[11,3],[12,3]],

"fogRate":25,
"delAttackSpeed":25

}
