{
"row":13,
"col":7,
"isloop":0,
"iswood":1,
"datas":[2,2,2,2,2,2,2,2,2,2,2,2,2,
2,1,1,1,2,2,2,2,2,2,2,2,2,
2,2,2,1,2,2,2,2,2,2,4,4,2,
1,1,1,1,1,1,1,1,1,1,1,1,1,
2,1,2,1,2,2,2,2,2,2,2,2,0,
2,1,1,1,2,2,2,2,4,2,2,2,2,
2,2,2,2,2,2,2,2,2,2,2,2,2],

"it1":[622,627,0,622,627,0,622,401,627,0,626,0,401,
410,0,0,0,630,0,625,625,627,0,628,0,401,
622,622,0,0,0,0,0,0,627,0,0,0,622,
0,0,0,0,0,0,0,0,0,0,0,0,0,
625,0,622,0,622,622,624,625,622,629,0,401,0,
0,0,0,0,625,622,0,0,0,0,0,627,0,
622,622,622,622,0,622,622,622,401,401,622,627,0],

"it2":[],

"point1": [[0,3],[12,3]],
"point2": [[0,3],[12,3]],
"point3": [[1,1],[3,1],[3,5],[1,5],[1,3],[12,3]],
"point4": [[1,1],[3,1],[3,5],[1,5],[1,3],[12,3]],

"fogRate":25,
"delAttackSpeed":25

}
