{
"row":13,
"col":7,
"isloop":0,
"iswood":1,
"datas":[2,2,2,2,2,2,2,2,2,2,2,2,2,
2,2,2,2,2,2,2,2,2,2,2,2,2,
2,2,2,2,2,2,1,1,1,1,1,2,2,
2,2,2,2,2,2,1,4,4,4,1,2,2,
2,2,1,1,1,1,1,4,4,4,1,2,2,
2,2,1,2,2,2,1,4,4,4,1,2,2,
1,1,1,2,2,2,0,4,4,4,1,2,2],

"it1":[622,622,630,0,622,622,622,625,630,0,622,622,622,
622,622,0,0,622,622,621,0,0,0,622,630,0,
621,622,622,622,630,0,0,0,0,0,0,0,0,
621,627,0,622,0,0,0,0,0,0,0,406,0,
630,0,0,0,0,0,0,0,0,0,0,0,0,
0,0,0,622,622,622,0,0,0,0,0,622,622,
0,0,0,0,622,622,0,0,0,0,0,622,622],

"it2":[0,0,0,0,0,0,0,0,0,0,0,0,0,
0,0,0,0,0,0,0,0,0,0,0,0,0,
0,0,0,0,0,6031,0,0,0,0,0,6031,0,
0,0,0,0,0,0,0,0,0,0,0,0,0,
0,6031,0,0,0,0,0,0,0,0,0,0,0,
0,0,0,0,0,0,0,0,0,0,0,0,0,
0,0,0,0,0,0,0,0,0,0,0,0,0],

"point1": [[0,6],[2,6],[2,4],[6,4],[6,5]],
"point2": [[0,6],[2,6],[2,4],[6,4],[6,5]],
"point3": [[10,6],[10,2],[6,2],[6,5]],
"point4": [[10,6],[10,2],[6,2],[6,5]],

"fogRate":25,
"delAttackSpeed":25

}
