{
"row":13,
"col":7,
"isloop":0,
"iswood":1,
"datas":[2,1,1,1,1,1,1,1,1,1,1,1,1,
1,1,4,2,2,4,2,2,4,4,2,2,0,
1,2,2,1,1,1,1,1,1,1,1,1,1,
1,2,2,1,2,2,1,1,1,2,2,4,1,
1,2,2,1,1,1,1,1,1,2,2,4,1,
1,1,1,1,1,1,1,1,1,1,1,1,1,
2,2,2,2,2,2,2,2,2,2,2,2,2],

"it1":[410,0,0,0,0,0,0,0,0,0,0,0,0,
0,0,0,628,0,0,626,0,0,0,412,0,0,
0,622,410,0,0,0,0,0,0,0,0,0,0,
0,627,0,0,425,401,0,0,0,621,621,0,0,
0,626,0,0,0,0,0,0,0,621,621,0,0,
0,0,0,0,0,0,0,0,0,0,0,0,0,
627,0,401,626,0,627,0,620,626,0,628,0,622],

"it2":[0,0,0,0,0,0,0,0,0,0,0,0,0,
0,0,0,0,0,0,0,0,0,0,0,0,0,
0,0,0,0,0,0,0,0,0,0,0,0,0,
0,0,0,0,3031,0,0,0,0,0,0,0,0,
0,0,0,0,0,0,0,0,0,0,0,0,0,
0,0,0,0,0,0,0,0,0,0,0,0,0,
0,0,0,0,0,0,0,0,0,0,0,0,0],

"point1": [[6,3],[8,3],[8,4],[3,4],[3,2],[12,2],[12,5],[0,5],[0,1],[1,1],[1,0],[12,0]],
"point2": [[6,3],[8,3],[8,4],[3,4],[3,2],[12,2],[12,5],[0,5],[0,1],[1,1],[1,0],[12,0]],
"point3": [[0,5],[0,1],[1,1],[1,0],[12,0]],
"point4": [[0,5],[0,1],[1,1],[1,0],[12,0]],

"fogRate":25,
"delAttackSpeed":25

}
