{
"row":13,
"col":7,
"isloop":0,
"datas":[2,2,1,2,2,2,1,1,1,1,2,2,2,
2,2,1,2,2,2,1,2,2,2,2,2,2,
2,2,1,2,2,2,1,2,2,2,2,2,2,
2,1,1,1,1,1,1,1,1,1,1,1,1,
2,2,1,2,2,2,2,2,2,2,2,2,0,
2,2,1,2,2,2,2,2,2,2,2,2,2,
2,2,1,1,1,1,2,2,2,2,2,2,2],

"it1":[762,0,0,765,769,0,0,0,0,0,765,769,0,
762,762,0,0,0,0,0,763,764,765,0,0,0,
762,762,0,762,761,762,0,0,0,0,762,401,762,
761,0,0,0,0,0,0,0,0,0,0,0,0,
761,401,0,760,760,761,762,763,764,765,769,0,0,
761,761,0,760,760,0,762,0,0,0,0,0,765,
767,0,0,0,0,0,760,760,761,401,761,762,0],

"it2":[],

"point1": [[1,3],[12,3]],
"point2": [[5,6],[2,6],[2,3],[12,3]],
"point3": [[9,0],[6,0],[6,3],[12,3]],
"point4": [[2,0],[2,3],[12,3]],

"chuShouId":773,
"chouShouRate":15,
"chuShouCount":[1,2]

}
