{
"row":13,
"col":7,
"isloop":0,
"iswood":1,
"datas":[2,1,1,1,1,1,1,1,2,4,2,2,2,
2,2,2,2,2,2,2,1,2,2,2,1,2,
2,1,1,1,2,2,2,1,1,1,2,1,2,
2,1,2,1,2,2,2,1,0,1,2,1,2,
2,1,2,2,4,2,2,1,2,1,2,1,2,
2,1,1,1,1,1,1,1,2,1,1,1,2,
2,2,2,2,2,2,2,2,2,2,2,2,2],

"it1":[401,0,0,0,0,0,0,0,622,0,621,401,622,
621,620,621,622,620,621,620,0,622,622,621,0,621,
401,0,0,0,411,621,622,0,0,0,621,0,621,
625,0,622,0,620,621,622,0,0,0,625,0,0,
0,0,626,0,0,621,622,0,412,0,0,0,620,
401,0,0,0,0,0,0,0,412,0,0,0,411,
622,622,620,621,622,626,0,401,621,622,626,0,401],

"it2":[],

"point1": [[11,1],[11,5],[9,5],[9,2],[8,2]],
"point2": [[3,3],[3,2],[1,2],[1,5],[7,5],[7,2],[8,2]],
"point3": [[3,3],[3,2],[1,2],[1,5],[7,5],[7,2],[8,2]],
"point4": [[1,0],[7,0],[7,2],[8,2]],
"point5": [[1,0],[7,0],[7,2],[8,2]]

}
