{
"row":13,
"col":7,
"isloop":0,
"iswood":1,
"datas":[2,2,2,2,2,2,2,2,2,2,2,2,2,
2,2,2,2,2,2,2,1,1,1,1,1,2,
2,1,1,1,1,2,2,1,2,2,2,1,2,
2,1,2,2,1,2,2,1,2,2,2,1,2,
2,1,2,2,1,2,2,1,2,2,2,1,2,
2,1,1,1,1,1,1,1,1,1,1,1,2,
2,2,2,2,2,2,0,2,2,2,2,2,2],

"it1":[623,620,621,622,628,0,621,622,628,0,628,0,401,
0,622,622,628,0,0,410,0,0,0,0,0,401,
401,0,0,0,0,411,0,0,412,621,625,0,401,
401,0,406,0,0,626,0,0,630,0,0,0,401,
401,0,0,0,0,626,0,0,0,0,412,0,401,
410,0,0,0,0,0,0,0,0,0,0,0,411,
401,621,620,621,622,622,0,620,621,620,621,628,0],

"it2":[0,0,0,0,0,0,0,0,0,0,0,0,0,
0,0,0,0,0,0,0,0,0,0,0,0,0,
0,0,0,0,0,0,0,0,0,0,0,0,0,
0,0,0,0,0,0,0,0,0,0,0,0,0,
0,0,0,0,0,0,0,0,0,0,0,0,0,
6031,0,0,0,0,0,0,0,0,0,0,0,6031,
0,0,4031,0,0,0,0,4031,0,4031,0,0,0],

"point1": [[4,4],[4,2],[1,2],[1,5],[6,5]],
"point2": [[4,4],[4,2],[1,2],[1,5],[6,5]],
"point3": [[7,4],[7,1],[11,1],[11,5],[6,5]],
"point4": [[7,4],[7,1],[11,1],[11,5],[6,5]]

}
