{
"row":13,
"col":7,
"isloop":0,
"datas":[2,2,2,2,2,2,1,2,2,2,2,2,2,
2,2,2,2,2,2,1,2,2,2,2,2,2,
2,2,2,2,2,2,1,2,2,2,2,2,2,
1,1,1,1,1,1,1,1,1,1,1,1,1,
2,2,2,2,2,1,1,1,2,2,2,2,2,
2,2,2,2,2,1,1,1,2,2,2,2,2,
2,2,2,2,2,2,0,2,2,2,2,2,2],

"it1":[770,0,406,0,770,0,0,770,0,406,0,770,0,
0,0,0,0,0,0,0,0,0,0,0,0,0,
760,412,762,404,767,0,0,767,0,404,762,412,760,
0,0,0,0,0,0,0,0,0,0,0,0,0,
401,761,417,762,765,0,0,0,765,762,417,761,401,
770,0,769,0,0,0,0,0,0,769,0,770,0,
0,0,0,0,762,0,0,0,762,0,0,0,0],

"it2":[0,0,0,0,0,0,0,0,0,0,0,0,0,
0,0,0,0,0,0,0,0,0,0,0,0,0,
0,0,0,1000,0,0,0,0,0,1000,0,0,0,
0,0,0,0,0,0,0,0,0,0,0,0,0,
0,0,0,0,0,0,0,0,0,0,0,0,0,
0,0,0,0,0,0,0,0,0,0,0,0,0,
0,0,0,0,0,0,0,0,0,0,0,0,0],

"point1": [[0,3],[5,3],[5,5],[6,5]],
"point2": [[0,3],[5,3],[5,5],[6,5]],
"point3": [[12,3],[7,3],[7,5],[6,5]],
"point4": [[12,3],[7,3],[7,5],[6,5]],
"point5": [[6,0],[6,5]],

"jinjuNum":4,

"chuShouId":773,
"chouShouRate":15,
"chuShouCount":[1,2]

}
