{
"row":13,
"col":7,
"isloop":0,
"datas":[1,3,3,3,3,3,3,3,3,3,3,3,1,
3,2,2,2,2,2,2,2,2,2,2,2,3,
3,2,2,2,2,2,2,2,2,2,2,2,3,
3,3,3,3,3,3,1,3,3,3,3,3,3,
3,2,2,2,2,2,0,2,2,2,2,2,3,
3,2,2,2,2,2,2,2,2,2,2,2,3,
1,3,3,3,3,3,3,3,3,3,3,3,1],

"it1":[0,0,0,0,0,0,0,0,0,0,0,0,0,
0,404,404,404,404,404,404,404,404,404,404,404,0,
0,404,404,404,404,404,404,404,404,404,404,404,0,
0,0,0,0,0,0,0,0,0,0,0,0,0,
0,404,404,404,404,404,0,404,404,404,404,404,0,
0,404,404,404,404,404,404,404,404,404,404,404,0,
0,0,0,0,0,0,0,0,0,0,0,0,0],

"it2":[0,0,0,0,0,0,0,0,0,0,0,0,0,
0,1000,1000,1000,1000,1000,1000,1000,1000,1000,1000,1000,0,
0,1000,1000,1000,1000,1000,1000,1000,1000,1000,1000,1000,0,
0,0,0,0,0,0,0,0,0,0,0,0,0,
0,1000,1000,1000,1000,1000,0,1000,1000,1000,1000,1000,0,
0,1000,1000,1000,1000,1000,1000,1000,1000,1000,1000,1000,0,
0,0,0,0,0,0,0,0,0,0,0,0,0],

"point1": [[0,0],[6,3]],
"point2": [[0,0],[6,3]],
"point3": [[0,6],[6,3]],
"point4": [[12,6],[6,3]],
"point5": [[12,0],[6,3]],

"chuShouId":773,
"chouShouRate":15,
"chuShouCount":[1,2]

}
