{
"row":13,
"col":7,
"isloop":1,
"datas":[2,2,1,1,1,1,1,1,1,1,1,2,2,
2,2,1,1,1,1,1,1,1,1,1,2,2,
2,2,1,1,1,1,1,1,1,1,1,2,2,
2,2,1,2,2,2,2,2,2,2,1,2,2,
1,1,1,1,1,1,1,1,1,1,1,1,1,
1,2,2,2,2,2,2,2,2,2,2,2,1,
1,1,1,1,1,1,1,1,1,1,1,1,1],

"it1":[0,410,0,0,0,0,0,0,0,0,0,762,0,
765,403,0,0,0,0,0,0,0,0,0,411,401,
0,410,0,0,0,0,0,0,0,0,0,770,0,
768,0,0,425,768,0,412,768,0,425,0,0,0,
0,0,0,0,0,0,0,0,0,0,0,0,0,
0,767,0,768,0,762,0,762,768,0,767,0,0,
0,0,0,0,0,0,0,0,0,0,0,0,0],

"it2":[0,0,0,0,0,0,0,0,0,0,0,0,0,
0,0,0,0,0,0,0,0,0,0,0,0,0,
0,0,0,0,0,0,0,0,0,0,0,0,0,
0,0,0,7011,0,0,0,0,0,7011,0,0,0,
0,0,0,0,0,0,0,0,0,0,0,0,0,
0,0,0,0,0,0,0,0,0,0,0,0,0,
0,0,0,0,0,0,0,0,0,0,0,0,0],

"point1": [[2,0],[10,0],[10,1],[2,1],[2,2],[10,2],[10,4],[12,4],[12,6],[0,6],[0,4],[2,4],[2,0]],
"point2": [[2,0],[10,0],[10,1],[2,1],[2,2],[10,2],[10,4],[12,4],[12,6],[0,6],[0,4],[2,4],[2,0]],
"point3": [[0,6],[12,6],[12,4],[0,4],[0,6]],
"point4": [[0,6],[12,6],[12,4],[0,4],[0,6]],

"jinjuNum":1,

"chuShouId":773,
"chouShouRate":10,
"chuShouCount":[1,2]

}
