{
"row":13,
"col":7,
"isloop":0,
"datas":[1,3,3,3,3,3,3,3,3,3,3,3,1,
3,2,2,2,2,2,2,2,2,2,2,2,3,
3,2,3,3,3,3,3,3,3,3,3,2,3,
3,2,3,2,2,2,2,2,2,2,3,2,3,
3,2,3,2,1,3,3,3,3,3,3,2,3,
3,2,3,3,0,2,2,2,2,2,2,2,3,
1,2,3,3,3,3,3,3,3,3,3,3,1],

"it1":[0,0,0,0,0,0,0,0,0,0,0,0,0,
0,412,417,417,417,417,417,417,417,417,417,412,0,
0,417,0,0,0,0,0,0,0,0,0,417,0,
0,417,0,412,417,417,417,412,417,412,0,417,0,
0,417,0,417,0,0,0,0,0,0,0,417,0,
0,412,0,0,0,417,417,417,417,417,417,412,0,
0,417,0,0,0,0,0,0,0,0,0,0,0],

"it2":[],

"point1": [[0,6],[4,4]],
"point2": [[0,0],[4,4]],
"point3": [[12,0],[4,4]],
"point4": [[12,6],[4,4]],
"point5": [[0,6],[4,4]],

"chuShouId":773,
"chouShouRate":10,
"chuShouCount":[1,2]

}
