{
"row":13,
"col":7,
"isloop":0,
"iswood":1,
"datas":[2,2,2,2,2,2,2,2,2,2,2,2,2,
2,2,2,2,2,2,1,1,1,1,1,1,1,
2,2,2,2,2,2,1,2,2,2,2,2,2,
2,2,2,2,2,2,1,1,1,1,1,1,1,
2,2,2,2,2,2,2,2,2,2,2,2,0,
2,2,2,2,2,2,2,2,2,2,2,2,2,
2,2,2,2,2,2,2,2,2,2,2,2,2],

"it1":[0,621,621,621,624,621,622,628,0,628,0,622,622,
623,624,625,621,0,621,0,0,0,0,0,0,0,
0,0,0,621,621,621,0,622,628,0,628,0,622,
620,622,630,0,621,622,0,0,0,0,0,0,0,
621,622,0,0,620,620,622,622,406,0,622,622,0,
0,620,621,622,621,622,622,622,0,0,622,622,622,
621,621,621,621,622,622,627,0,620,621,622,621,622],

"it2":[],

"point1": [[12,1],[6,1],[6,3],[12,3]],
"point2": [[12,1],[6,1],[6,3],[12,3]]

}
