{
"row":13,
"col":7,
"isloop":0,
"destroyed1":[[0,5],[2,5]],
"destroyed2":[[0,5],[2,5]],
"destroyed3":[[0,0],[2,0]],
"destroyed4":[[0,0],[2,0]],
"datas":[2,2,1,3,3,3,2,2,2,2,2,2,2,
2,2,3,3,2,2,3,2,2,3,2,2,2,
3,2,2,3,3,3,3,3,3,3,3,3,3,
3,2,2,3,3,2,2,3,3,2,2,2,3,
3,3,3,3,2,2,2,3,3,2,2,3,3,
2,2,1,3,2,2,2,2,2,2,2,3,1,
2,2,3,3,3,3,2,3,2,2,2,3,0],

"it1":[400,0,0,0,0,0,401,630,0,401,624,630,0,
0,0,0,0,628,0,0,0,0,0,0,0,0,
0,630,0,0,0,0,0,0,0,0,0,0,0,
0,0,0,0,0,630,0,0,0,630,0,401,0,
0,0,0,0,622,0,0,0,0,0,0,0,0,
400,0,0,0,628,0,625,401,630,0,401,0,0,
0,0,0,0,0,0,0,0,0,0,401,0,0],

"it2":[],

"point1": [[2,5],[12,5]],
"point2": [[2,5],[12,5]],
"point3": [[2,0],[12,5]],
"point4": [[2,0],[12,5]]

}
