{
"row":13,
"col":7,
"isloop":0,
"iswood":1,
"datas":[2,2,2,2,2,2,2,2,2,2,2,2,2,
2,2,2,2,2,2,2,2,2,2,2,2,2,
2,2,2,2,2,2,2,2,2,2,2,2,2,
2,1,1,1,1,1,1,1,1,1,1,2,2,
2,2,1,1,2,2,2,2,2,2,1,2,2,
2,2,2,1,1,2,2,2,2,2,1,1,1,
2,2,2,2,1,1,2,2,2,2,2,2,0],

"it1":[620,621,622,630,0,630,0,622,626,0,620,621,622,
620,621,621,0,0,0,0,620,621,406,0,621,622,
621,0,621,620,621,622,622,621,622,0,0,628,0,
410,0,0,0,0,0,0,0,0,0,0,628,0,
621,622,0,0,621,630,0,622,626,0,0,403,622,
620,621,620,0,0,0,0,621,622,622,0,0,0,
622,412,627,0,0,0,411,401,627,0,622,412,0],

"it2":[],

"point1": [[1,3],[10,3],[10,5],[12,5]],
"point2": [[1,3],[10,3],[10,5],[12,5]],
"point3": [[5,6],[4,6],[4,5],[3,5],[3,4],[2,4],[2,3],[10,3],[10,5],[12,5]],
"point4": [[5,6],[4,6],[4,5],[3,5],[3,4],[2,4],[2,3],[10,3],[10,5],[12,5]]

}
