{
"row":13,
"col":7,
"isloop":0,
"iswood":1,
"datas":[2,2,2,2,2,2,2,2,2,2,2,2,2,
2,1,1,1,2,1,1,1,2,1,1,1,2,
2,1,2,1,2,1,2,1,2,1,2,1,2,
1,1,1,1,1,1,1,1,1,1,1,1,2,
0,1,2,2,2,1,2,2,2,1,2,2,2,
2,1,1,1,2,1,1,1,2,1,1,1,2,
2,2,2,2,2,2,2,2,2,2,2,2,2],

"it1":[627,0,627,0,622,622,626,0,0,622,622,622,622,
622,0,0,0,625,0,0,0,622,0,0,0,625,
622,0,401,0,0,0,401,0,622,0,401,0,0,
0,0,0,0,0,0,0,0,0,0,0,0,411,
0,0,626,0,622,0,621,622,622,0,628,0,622,
625,0,0,0,411,0,0,0,411,0,0,0,411,
0,622,622,622,622,626,0,622,622,627,0,628,0],

"it2":[],

"point1": [[11,5],[9,5],[9,1],[11,1],[11,3],[0,3]],
"point2": [[7,5],[5,5],[5,1],[7,1],[7,3],[0,3]],
"point3": [[3,5],[1,5],[1,1],[3,1],[3,3],[0,3]]

}
