{
"row":13,
"col":7,
"isloop":1,
"iswood":1,
"datas":[2,2,2,2,1,1,1,1,1,1,1,1,2,
2,2,2,2,1,2,2,2,2,2,2,1,2,
2,1,1,1,1,1,1,1,2,2,2,1,2,
2,1,2,2,1,2,2,1,2,2,2,1,2,
2,1,1,1,1,1,1,1,2,2,2,1,2,
2,2,2,2,1,2,2,2,2,2,1,1,2,
2,2,2,2,1,1,1,1,1,1,1,2,2],

"it1":[401,401,631,0,0,0,0,0,0,0,0,0,411,
401,401,631,0,0,628,0,620,620,620,0,0,622,
620,0,0,0,0,0,0,0,620,620,625,0,622,
621,0,631,0,0,620,621,0,628,0,0,0,625,
621,0,0,0,0,0,0,0,624,628,0,0,0,
401,401,629,0,0,620,621,622,0,410,0,0,622,
401,401,0,0,0,0,0,0,0,0,0,622,621],

"it2":[],

"point1": [[1,4],[7,4],[7,2],[1,2],[1,4]],
"point2": [[1,4],[7,4],[7,2],[1,2],[1,4]],
"point3": [[4,6],[10,6],[10,5],[11,5],[11,0],[4,0],[4,6]],
"point4": [[4,6],[10,6],[10,5],[11,5],[11,0],[4,0],[4,6]]

}
