{
"row":13,
"col":7,
"isloop":0,
"datas":[2,1,1,1,1,2,2,2,2,2,2,2,2,
2,1,2,2,1,2,2,1,1,1,1,1,2,
2,1,2,2,1,1,1,1,2,2,2,1,2,
2,2,2,2,2,2,2,2,2,2,2,1,1,
2,1,2,2,1,1,1,1,2,2,2,1,0,
2,1,2,2,1,2,2,1,1,1,1,1,2,
2,1,1,1,1,2,2,2,2,2,2,2,2],

"it1":[425,0,0,0,0,425,425,426,0,421,426,0,431,
430,0,434,0,0,425,425,0,0,0,0,0,0,
0,0,0,0,0,0,0,0,421,426,0,0,421,
425,426,0,421,427,421,427,421,422,0,0,0,0,
430,0,434,0,0,0,0,0,421,426,0,0,0,
0,0,0,0,0,425,425,0,0,0,0,0,431,
425,0,0,0,0,425,425,426,0,421,426,0,0],

"it2":[6021,0,0,0,0,7011,7011,0,0,0,0,0,0,
0,0,0,0,0,7011,7011,0,0,0,0,0,0,
0,0,0,0,0,0,0,0,0,0,0,0,0,
1011,0,0,0,0,3011,0,0,0,0,0,0,0,
0,0,0,0,0,0,0,0,0,0,0,0,0,
0,0,0,0,0,7011,7011,0,0,0,0,0,0,
6021,0,0,0,0,7011,7011,0,0,0,0,0,0],

"point1": [[1,4],[1,6],[4,6],[4,4],[7,4],[7,5],[11,5],[11,3],[12,3]],
"point2": [[1,4],[1,6],[4,6],[4,4],[7,4],[7,5],[11,5],[11,3],[12,3]],
"point3": [[1,2],[1,0],[4,0],[4,2],[7,2],[7,1],[11,1],[11,3],[12,3]],
"point4": [[1,2],[1,0],[4,0],[4,2],[7,2],[7,1],[11,1],[11,3],[12,3]]

}
