{
"row":13,
"col":7,
"isloop":0,
"datas":[2,2,1,1,2,2,2,1,1,1,1,1,1,
2,2,1,1,1,1,1,1,2,2,2,2,2,
2,2,1,2,2,2,2,1,2,2,2,2,2,
2,2,1,2,2,2,2,1,1,1,1,1,1,
2,2,1,2,2,2,2,1,2,2,2,2,0,
2,2,1,1,1,1,1,1,2,2,2,2,2,
2,2,1,1,2,2,2,2,2,2,2,2,2],

"it1":[762,410,0,0,767,0,762,0,0,0,0,0,0,
761,0,0,0,0,0,0,0,765,762,768,0,762,
761,760,0,762,401,761,401,0,0,0,762,762,762,
761,765,0,769,0,762,410,0,0,0,0,0,0,
761,0,0,0,0,762,401,0,768,0,769,0,0,
763,401,0,0,0,0,0,0,765,762,0,0,762,
0,410,0,0,760,760,762,760,0,760,762,762,762],

"it2":[],

"point1": [[2,3],[2,6],[3,6],[3,5],[7,5],[7,3],[12,3]],
"point2": [[2,3],[2,0],[3,0],[3,1],[7,1],[7,3],[12,3]],
"point3": [[12,0],[7,0],[7,3],[12,3]]

}
