{
"row":13,
"col":7,
"isloop":0,
"datas":[2,2,2,2,2,2,2,2,2,2,2,2,2,
2,2,2,2,1,1,1,1,1,1,2,2,2,
2,2,2,2,2,2,2,2,2,1,2,2,2,
2,2,2,1,1,1,2,2,2,1,2,2,2,
2,2,2,1,2,1,2,1,1,1,1,1,1,
2,1,1,1,2,1,2,1,2,2,2,2,0,
2,2,2,2,2,1,1,1,2,2,2,2,2],

"it1":[761,762,768,0,401,768,0,401,768,0,761,768,0,
761,768,0,410,0,0,0,0,0,0,761,761,761,
764,768,0,762,761,762,761,769,0,0,768,0,761,
0,769,0,0,0,0,0,0,0,0,762,417,762,
401,0,0,0,765,0,765,0,0,0,0,0,0,
410,0,0,0,0,0,0,0,761,417,762,761,0,
762,768,0,401,410,0,0,0,761,767,0,768,0],

"it2":[],

"point1": [[1,5],[3,5],[3,3],[5,3],[5,6],[7,6],[7,4],[9,4],[12,4]],
"point2": [[1,5],[3,5],[3,3],[5,3],[5,6],[7,6],[7,4],[9,4],[12,4]],
"point3": [[4,1],[9,1],[9,4],[12,4]],
"point4": [[4,1],[9,1],[9,4],[12,4]]

}
