{
"row":13,
"col":7,
"isloop":0,
"datas":[2,2,1,1,1,1,1,2,2,2,2,2,2,
2,2,2,2,2,2,1,1,2,2,2,2,2,
2,2,2,2,2,2,2,1,2,2,2,2,2,
1,1,1,1,1,1,1,1,1,1,1,1,1,
2,2,2,2,2,2,2,2,2,2,2,2,0,
2,2,2,2,2,2,2,2,2,2,2,2,2,
2,2,2,2,2,2,2,2,2,2,2,2,2],

"it1":[763,764,0,0,0,0,0,766,0,766,0,763,764,
0,0,765,763,764,765,0,0,764,765,762,0,0,
760,761,0,0,0,0,0,0,0,0,762,760,761,
0,0,0,0,0,0,0,0,0,0,0,0,0,
763,764,0,763,764,765,769,0,764,765,762,763,0,
0,0,762,0,0,0,0,0,0,0,762,0,762,
760,761,768,0,767,0,761,766,0,766,0,760,761],

"it2":[],

"point1": [[0,3],[12,3]],
"point2": [[0,3],[12,3]],
"point3": [[2,0],[6,0],[6,1],[7,1],[7,3],[12,3]],
"point4": [[2,0],[6,0],[6,1],[7,1],[7,3],[12,3]]

}
