{
"row":13,
"col":7,
"isloop":0,
"datas":[2,2,2,1,1,1,1,1,1,1,1,2,2,
2,2,2,1,2,2,2,2,2,2,0,2,2,
2,2,2,1,1,1,1,1,2,2,2,2,2,
2,2,2,1,2,2,2,1,2,2,2,2,2,
2,2,2,1,1,1,1,1,2,2,2,2,2,
2,2,2,1,2,2,2,2,2,2,2,2,2,
2,2,2,1,1,1,1,1,1,1,1,2,2],

"it1":[401,762,760,0,0,0,0,0,0,0,0,762,401,
760,766,0,0,762,762,767,0,768,0,0,762,762,
762,761,765,0,0,0,0,0,763,764,765,762,762,
761,762,0,0,0,768,0,0,0,0,0,762,762,
760,760,761,0,0,0,0,0,760,761,762,762,762,
760,762,762,0,760,761,762,766,0,767,0,768,0,
401,768,0,0,0,0,0,0,0,0,0,761,401],

"it2":[],

"point1": [[10,6],[3,6],[3,0],[10,0]],
"point2": [[10,6],[3,6],[3,0],[10,0]],
"point3": [[10,6],[3,6],[3,4],[7,4],[7,2],[3,2],[3,0],[10,0]],
"point4": [[10,6],[3,6],[3,4],[7,4],[7,2],[3,2],[3,0],[10,0]]

}
