{
"row":13,
"col":7,
"isloop":1,
"datas":[2,2,2,2,2,1,1,1,2,2,2,2,2,
2,2,2,2,1,1,2,1,1,2,2,2,2,
2,1,1,1,1,2,2,2,1,1,1,1,2,
2,1,2,2,2,2,2,2,2,2,2,1,2,
2,1,1,1,1,2,2,2,1,1,1,1,2,
2,2,2,2,1,1,2,1,1,2,2,2,2,
2,2,2,2,2,1,1,1,2,2,2,2,2],

"it1":[433,0,431,426,0,0,0,0,0,426,0,433,0,
0,0,0,424,0,0,432,0,0,427,421,0,0,
423,0,0,0,0,423,0,424,0,0,0,0,431,
430,0,426,0,429,0,403,429,0,426,0,0,0,
0,0,0,0,0,424,432,423,0,0,0,0,423,
433,0,421,427,0,0,0,0,0,424,430,433,0,
0,0,426,0,0,0,0,0,426,0,0,0,0],

"it2":[0,0,0,0,0,0,0,0,0,0,0,0,0,
0,0,0,0,0,0,0,0,0,0,0,0,0,
0,0,0,0,0,7011,5021,7011,0,0,0,0,0,
0,0,0,0,0,5021,0,5021,0,0,0,0,0,
0,0,0,0,0,7011,5021,7011,0,0,0,0,0,
0,0,0,0,0,0,0,0,0,0,0,0,0,
0,0,0,0,0,0,0,0,0,0,0,0,0],

"point1": [[4,5],[5,5],[5,6],[7,6],[7,5],[8,5],[8,4],[11,4],[11,2],[8,2],[8,1],[7,1],[7,0],[5,0],[5,1],[4,1],[4,2],[1,2],[1,4],[4,4],[4,5]],
"point2": [[4,5],[5,5],[5,6],[7,6],[7,5],[8,5],[8,4],[11,4],[11,2],[8,2],[8,1],[7,1],[7,0],[5,0],[5,1],[4,1],[4,2],[1,2],[1,4],[4,4],[4,5]]

}
