{
"row":13,
"col":7,
"isloop":0,
"datas":[2,2,2,2,2,1,1,1,1,1,1,1,2,
2,2,2,2,2,1,2,1,1,1,1,0,2,
2,2,2,2,1,1,2,1,2,2,2,2,2,
2,2,2,2,1,2,2,1,2,2,2,2,2,
2,2,2,2,1,2,2,1,2,2,2,2,2,
2,2,2,1,1,2,1,1,2,2,2,2,2,
2,2,2,1,1,1,1,2,2,2,2,2,2],

"it1":[762,761,760,763,765,0,0,0,0,0,0,0,763,
761,417,761,0,0,0,762,0,0,0,0,0,0,
760,761,762,404,0,0,0,0,764,761,769,0,764,
766,0,767,0,0,0,765,0,0,765,0,0,0,
762,761,760,760,0,764,0,0,762,0,404,765,401,
761,417,761,0,0,0,0,0,764,769,0,0,761,
760,761,762,0,0,0,0,761,0,0,0,768,0],

"it2":[0,0,0,0,0,0,0,0,0,0,0,0,0,
0,0,0,0,0,0,0,0,0,0,0,0,0,
0,0,0,1000,0,0,0,0,0,0,0,0,0,
0,0,0,0,0,0,0,0,0,0,0,0,0,
0,0,0,0,0,0,0,0,0,0,1000,0,0,
0,0,0,0,0,0,0,0,0,0,0,0,0,
0,0,0,0,0,0,0,0,0,0,0,0,0],

"point1": [[10,1],[7,1],[7,5],[6,5],[6,6],[3,6],[3,5],[4,5],[4,2],[5,2],[5,0],[11,0]],
"point2": [[10,1],[7,1],[7,5],[6,5],[6,6],[3,6],[3,5],[4,5],[4,2],[5,2],[5,0],[11,0]]

}
