{
"row":13,
"col":7,
"isloop":0,
"datas":[2,2,2,2,2,2,2,2,2,2,2,2,2,
2,2,2,1,1,1,1,1,1,1,2,2,2,
2,2,2,1,2,2,2,2,2,1,2,2,2,
1,1,1,1,2,2,2,2,2,1,1,1,1,
2,2,2,1,2,2,2,2,2,1,2,2,0,
2,2,2,1,1,1,1,1,1,1,2,2,2,
2,2,2,2,2,2,2,2,2,2,2,2,2],

"it1":[764,770,0,767,0,761,768,0,767,0,406,0,764,
0,0,0,0,0,0,0,0,0,0,0,0,0,
768,0,0,0,417,412,417,412,417,0,767,0,760,
0,0,0,0,412,403,403,403,412,0,0,0,0,
768,0,760,0,417,412,417,412,417,0,762,0,0,
764,406,0,0,0,0,0,0,0,0,770,0,764,
0,0,0,767,0,768,0,761,767,0,0,0,0],

"it2":[],

"point1": [[0,3],[3,3],[3,5],[9,5],[9,3],[12,3]],
"point2": [[0,3],[3,3],[3,5],[9,5],[9,3],[12,3]],
"point3": [[0,3],[3,3],[3,1],[9,1],[9,3],[12,3]],
"point4": [[0,3],[3,3],[3,1],[9,1],[9,3],[12,3]],

"jinjuNum":1
}
