{
"row":13,
"col":7,
"isloop":1,
"datas":[2,2,2,2,2,2,2,2,2,2,2,2,2,
1,1,1,1,1,1,1,1,1,1,1,1,1,
1,2,2,2,1,2,2,2,1,2,2,2,1,
1,2,2,2,1,2,2,2,1,2,2,2,1,
1,2,2,2,1,2,2,2,1,2,2,2,1,
1,1,1,1,1,1,1,1,1,1,1,1,1,
2,2,2,2,2,2,2,2,2,2,2,2,2],

"it1":[766,0,767,0,768,0,417,768,0,767,0,766,0,
0,0,0,0,0,0,0,0,0,0,0,0,0,
0,768,0,765,0,403,403,403,0,762,770,0,0,
0,770,0,0,0,403,0,403,0,765,0,0,0,
0,0,0,762,0,403,403,403,0,0,768,0,0,
0,0,0,0,0,0,0,0,0,0,0,0,0,
766,0,767,0,768,0,417,768,0,767,0,766,0],

"it2":[],

"point1": [[4,5],[0,5],[0,1],[4,1],[4,5]],
"point2": [[8,5],[12,5],[12,1],[8,1],[8,5]],
"point3": [[6,5],[12,5],[12,1],[0,1],[0,5],[6,5]],
"point4": [[6,5],[0,5],[0,1],[12,1],[12,5],[6,5]],

"jinjuNum":2
}
