{
"row":13,
"col":7,
"isloop":0,
"datas":[1,3,3,3,3,3,3,3,3,3,3,3,2,
0,2,2,2,2,3,2,2,3,3,3,3,3,
2,2,3,2,3,3,3,3,3,2,2,2,3,
2,2,2,3,3,2,2,2,3,3,3,2,3,
2,2,3,3,3,2,2,2,2,2,3,2,2,
3,2,2,2,2,2,2,2,2,2,3,2,3,
2,1,3,3,3,3,3,3,3,3,3,3,1],

"it1":[0,0,0,0,0,0,0,0,0,0,0,0,411,
0,401,762,417,762,0,767,0,0,0,0,0,0,
770,0,0,403,0,0,0,0,0,403,403,417,0,
0,0,403,0,0,412,403,412,0,0,0,403,0,
412,403,0,0,0,403,417,403,770,0,0,403,401,
0,412,401,766,0,412,403,412,0,0,0,412,0,
410,0,0,0,0,0,0,0,0,0,0,0,0],

"it2":[],

"point1": [[1,6],[0,0]],
"point2": [[1,6],[0,0]],
"point3": [[12,6],[0,0]],
"point4": [[12,6],[0,0]],
"point5": [[12,6],[0,0]],

"jinjuNum":2
}
