{
"row":13,
"col":7,
"isloop":0,
"datas":[1,1,1,1,1,1,1,1,1,1,1,1,2,
2,2,2,2,2,2,2,2,2,2,2,1,1,
2,1,1,1,1,1,1,1,1,1,1,1,1,
2,2,2,2,2,1,1,1,1,2,2,1,1,
2,2,2,2,2,1,2,1,1,1,2,1,1,
2,2,2,2,2,1,2,0,2,1,1,1,1,
2,2,2,2,2,1,1,1,1,1,1,1,1],

"it1":[0,0,0,0,0,0,0,0,0,0,0,0,425,
431,426,0,429,0,423,429,0,426,0,423,0,0,
0,0,0,0,0,0,0,0,0,0,0,0,0,
429,0,434,0,432,0,0,0,0,426,0,0,0,
434,0,0,0,0,0,432,0,0,0,423,0,0,
0,0,403,434,0,0,0,0,0,0,0,0,0,
426,0,427,0,0,0,0,0,0,0,0,0,0],

"it2":[0,0,0,0,0,0,0,0,0,0,0,0,3021,
0,0,0,0,0,0,0,0,6011,0,0,0,0,
6011,0,0,0,0,0,0,0,0,0,0,0,0,
0,0,0,0,0,0,0,0,0,0,0,0,0,
0,0,0,0,0,0,0,0,0,0,0,0,0,
0,0,0,0,0,0,0,0,0,0,0,0,0,
0,0,0,0,0,0,0,0,0,0,0,0,0],

"point1": [[1,2],[11,2],[11,5],[9,5],[9,4],[7,4]],
"point2": [[1,2],[11,2],[11,5],[9,5],[9,4],[7,4]],
"point3": [[0,0],[11,0],[11,1],[12,1],[12,6],[5,6],[5,3],[8,3],[8,4],[7,4]],
"point4": [[0,0],[11,0],[11,1],[12,1],[12,6],[5,6],[5,3],[8,3],[8,4],[7,4]]

}
