{
"row":13,
"col":7,
"isloop":0,
"datas":[2,2,2,2,2,2,2,2,2,2,2,2,2,
2,1,1,1,1,1,1,1,1,1,1,1,2,
2,1,2,2,1,2,2,2,1,2,2,1,2,
2,1,2,2,1,2,2,2,1,2,2,1,2,
2,1,2,2,1,2,2,2,1,2,2,1,2,
2,1,1,1,1,1,1,1,1,1,1,1,2,
2,2,2,2,2,2,2,2,2,2,2,0,2],

"it1":[762,762,768,0,401,768,0,761,761,766,0,761,761,
764,0,0,0,0,0,0,0,0,0,0,0,765,
0,0,763,765,0,401,762,765,0,770,0,0,0,
764,0,0,0,0,769,0,0,0,0,0,0,761,
0,0,761,762,0,0,0,762,0,766,0,0,765,
765,0,0,0,0,0,0,0,0,0,0,0,0,
0,761,767,0,761,762,762,762,762,767,0,0,0],

"it2":[],

"point1": [[1,5],[11,5]],
"point2": [[1,5],[1,1],[11,1],[11,5]],
"point3": [[1,5],[4,5],[4,1],[8,1],[8,5],[11,5]],
"point4": [[1,5],[1,1],[8,1],[8,5],[11,5]],

"jinjuNum":1
}
