{
"row":13,
"col":7,
"isloop":0,
"datas":[2,2,2,2,2,2,2,2,2,2,2,2,2,
1,1,1,1,1,1,1,1,1,1,1,1,1,
1,2,2,2,2,2,2,2,2,1,2,2,2,
1,2,2,2,2,2,2,2,2,1,2,2,2,
1,1,1,1,1,1,1,1,1,1,1,1,1,
0,2,2,2,2,2,2,2,2,2,2,2,2,
2,2,2,2,2,2,2,2,2,2,2,2,2],

"it1":[766,0,762,761,762,762,762,761,762,762,762,761,0,
0,0,0,0,0,0,0,0,0,0,0,0,0,
0,762,406,0,762,762,406,0,762,0,769,0,765,
0,762,0,0,762,762,0,0,762,0,0,0,0,
0,0,0,0,0,0,0,0,0,0,0,0,0,
0,762,763,764,765,761,764,765,761,761,761,762,765,
761,762,0,0,0,761,0,0,761,761,761,762,0],

"it2":[],

"point1": [[12,4],[0,4]],
"point2": [[12,4],[9,4],[9,1],[0,1],[0,4]],
"point3": [[12,1],[0,1],[0,4]],
"point4": [[12,1],[9,1],[9,4],[0,4]]

}
