{
"row":13,
"col":7,
"isloop":0,
"datas":[2,2,1,1,1,2,2,2,1,1,1,2,2,
2,2,2,2,1,2,2,2,1,2,2,2,2,
2,2,2,2,1,1,1,1,1,2,2,2,2,
2,2,2,2,2,2,1,2,2,2,2,2,2,
1,1,1,1,1,1,1,1,1,1,1,1,1,
1,2,2,2,2,2,1,2,2,2,2,2,1,
1,2,2,2,2,2,0,2,2,2,2,2,1],

"it1":[761,763,0,0,0,769,0,761,0,0,0,762,762,
761,0,769,0,0,0,0,0,0,769,0,762,762,
768,0,0,0,0,0,0,0,0,0,0,761,761,
401,761,762,760,761,761,0,761,767,0,768,0,401,
0,0,0,0,0,0,0,0,0,0,0,0,0,
0,769,0,769,0,401,0,401,762,760,769,0,0,
0,0,0,0,0,760,0,760,761,762,0,0,0],

"it2":[],

"point1": [[10,0],[8,0],[8,2],[6,2],[6,4],[6,5]],
"point2": [[2,0],[4,0],[4,2],[6,2],[6,4],[6,5]],
"point3": [[0,6],[0,4],[6,4],[6,5]],
"point4": [[12,6],[12,4],[6,4],[6,5]]

}
