{
"row":13,
"col":7,
"isloop":0,
"datas":[1,1,1,1,1,2,2,2,2,2,2,2,2,
2,1,2,2,1,2,2,2,2,2,2,2,2,
2,1,2,2,1,1,1,2,2,2,2,2,2,
2,1,2,2,2,2,1,2,2,2,2,2,2,
2,1,1,1,1,1,1,2,2,2,2,2,2,
2,2,2,2,2,2,1,2,2,2,2,2,2,
2,2,2,2,2,2,0,2,2,2,2,2,2],

"it1":[0,0,0,0,0,768,0,767,0,761,761,417,417,
762,0,769,0,0,767,0,762,767,0,762,417,417,
762,0,0,0,0,0,0,769,0,769,0,762,761,
0,0,762,766,0,762,0,0,0,0,0,762,762,
764,0,0,0,0,0,0,762,762,768,0,762,762,
0,764,764,765,769,0,0,764,764,762,762,417,417,
762,0,0,0,0,0,0,0,0,762,762,417,417],

"it2":[],

"point1": [[0,0],[1,0],[1,4],[6,4],[6,5]],
"point2": [[0,0],[1,0],[1,4],[6,4],[6,5]],
"point3": [[0,0],[1,0],[4,0],[4,2],[6,2],[6,4],[6,5]],
"point4": [[0,0],[1,0],[4,0],[4,2],[6,2],[6,4],[6,5]]

}
