{
"row":13,
"col":7,
"isloop":0,
"datas":[2,1,1,1,1,1,2,2,2,2,2,2,2,
2,2,2,2,2,1,2,1,1,1,1,2,2,
2,2,2,2,2,1,2,1,2,2,1,2,2,
2,1,1,1,1,1,1,1,2,2,1,1,1,
2,2,2,2,2,1,2,1,2,2,1,2,0,
2,2,2,2,2,1,2,1,1,1,1,2,2,
2,1,1,1,1,1,2,2,2,2,2,2,2],

"it1":[410,0,0,0,0,0,401,401,762,767,0,768,0,
766,0,767,0,762,0,410,0,0,0,0,768,0,
761,762,761,761,762,0,404,0,769,0,0,767,0,
410,0,0,0,0,0,0,0,0,0,0,0,0,
763,764,765,769,0,0,404,0,766,0,0,0,0,
0,0,0,0,0,0,410,0,0,0,0,768,0,
410,0,0,0,0,0,401,401,762,0,762,768,0],

"it2":[0,0,0,0,0,0,0,0,0,0,0,0,0,
0,0,0,0,0,0,0,0,0,0,0,0,0,
0,0,0,0,0,0,903,0,0,0,0,0,0,
0,0,0,0,0,0,0,0,0,0,0,0,0,
0,0,0,0,0,0,903,0,0,0,0,0,0,
0,0,0,0,0,0,0,0,0,0,0,0,0,
0,0,0,0,0,0,0,0,0,0,0,0,0],

"point1": [[1,6],[5,6],[5,3],[7,3],[7,5],[10,5],[10,3],[12,3]],
"point2": [[1,3],[5,3],[7,3],[7,5],[10,5],[10,3],[12,3]],
"point3": [[1,3],[5,3],[7,3],[7,1],[10,1],[10,3],[12,3]],
"point4": [[1,0],[5,0],[5,3],[7,3],[7,1],[10,1],[10,3],[12,3]]

}
