{
"row":13,
"col":7,
"isloop":0,
"datas":[2,2,1,1,1,1,1,1,1,1,1,2,2,
2,2,2,2,2,2,2,2,2,2,1,2,2,
2,2,2,2,2,2,2,2,2,2,1,2,2,
2,2,1,1,1,1,1,1,1,1,1,2,2,
2,2,1,2,2,2,2,2,2,1,1,2,2,
2,2,1,1,1,1,1,2,2,1,1,2,2,
2,2,2,2,2,2,2,2,2,2,0,2,2],

"it1":[761,403,0,0,0,0,0,0,0,0,0,761,761,
770,0,762,413,0,761,761,761,761,762,0,770,0,
0,0,762,0,0,768,0,761,761,762,0,0,0,
767,0,0,0,0,0,0,0,0,0,0,767,0,
761,761,0,768,0,768,0,768,0,0,0,764,765,
761,761,0,0,0,0,0,762,0,0,0,0,0,
762,762,762,762,762,762,762,761,761,762,0,761,762],

"it2":[],

"point1": [[6,5],[2,5],[2,3],[9,3],[9,5],[10,5]],
"point2": [[6,5],[2,5],[2,3],[9,3],[9,5],[10,5]],
"point3": [[2,0],[10,0],[10,5]],
"point4": [[2,0],[10,0],[10,5]],

"jinjuNum":2
}
