{
"row":13,
"col":7,
"isloop":0,
"datas":[2,2,2,2,2,2,2,2,2,2,2,2,2,
2,2,2,2,2,2,2,2,2,2,2,2,2,
2,2,2,2,2,2,2,2,2,2,2,2,2,
1,1,1,1,1,1,1,1,1,1,1,1,1,
2,2,2,2,2,2,2,2,2,2,2,2,0,
2,2,2,2,2,2,2,2,2,2,2,2,2,
2,2,2,2,2,2,2,2,2,2,2,2,2],

"it1":[401,768,0,768,0,417,401,417,768,0,768,0,401,
417,403,417,417,0,417,403,417,0,417,417,403,417,
417,417,417,417,417,417,417,417,417,417,417,417,417,
0,0,0,0,0,0,0,0,0,0,0,0,0,
417,417,417,417,417,417,417,417,417,417,417,417,0,
417,403,417,417,0,417,403,417,0,417,417,403,417,
401,768,0,768,0,417,401,417,768,0,768,0,401],

"it2":[],

"point1": [[0,3],[12,3]],
"point2": [[0,3],[12,3]]

}
