{
"row":13,
"col":7,
"isloop":0,
"datas":[1,1,1,1,1,1,1,1,1,1,1,1,1,
1,2,2,2,2,2,2,2,2,2,2,2,1,
1,2,2,1,1,1,1,1,1,1,2,2,1,
1,2,2,1,2,2,2,2,2,0,2,2,1,
1,2,2,1,2,2,2,2,2,2,2,2,1,
1,2,2,1,1,1,1,1,1,1,1,1,1,
1,2,2,2,2,2,2,2,2,2,2,2,2],

"it1":[0,0,0,0,0,0,0,0,0,0,0,0,0,
0,425,428,423,429,0,0,422,0,403,426,0,0,
0,423,432,0,0,0,0,0,0,0,434,0,0,
0,403,0,0,432,0,434,0,432,0,0,0,0,
0,434,0,0,0,424,0,0,0,426,0,423,0,
0,0,0,0,0,0,0,0,0,0,0,0,0,
0,424,422,0,426,0,0,421,429,0,429,0,425],

"it2":[0,0,0,0,0,0,0,0,0,0,0,0,0,
0,4021,0,0,0,0,0,0,0,0,0,0,0,
0,0,0,0,0,0,0,0,0,0,0,0,0,
0,0,0,0,0,0,0,0,0,0,0,0,0,
0,0,0,0,0,0,0,0,0,0,0,0,0,
0,0,0,0,0,0,0,0,0,0,0,0,0,
0,0,0,0,0,0,0,0,0,0,0,0,6011],

"point1": [[0,6],[0,0],[12,0],[12,5],[3,5],[3,2],[9,2]],
"point2": [[0,6],[0,0],[12,0],[12,5],[3,5],[3,2],[9,2]]

}
