{
"row":13,
"col":7,
"isloop":0,
"datas":[3,3,3,3,3,3,2,3,3,3,3,3,3,
3,3,3,3,2,3,2,3,3,3,3,3,3,
3,3,3,3,2,3,2,3,3,3,3,3,3,
1,3,3,3,3,3,3,3,3,3,3,3,1,
3,3,3,3,2,3,2,3,3,3,3,3,0,
3,3,3,3,2,3,2,3,3,3,3,3,3,
3,3,3,3,2,3,3,3,3,3,3,3,3],

"it1":[0,0,0,0,0,0,424,0,0,0,0,0,0,
0,0,0,0,421,0,421,0,0,0,0,0,0,
0,0,0,0,424,0,424,0,0,0,0,0,0,
0,0,0,0,0,0,0,0,0,0,0,0,0,
0,0,0,0,421,0,421,0,0,0,0,0,0,
0,0,0,0,424,0,424,0,0,0,0,0,0,
0,0,0,0,421,0,0,0,0,0,0,0,0],

"it2":[],

"point1": [[0,3],[12,3]],
"point2": [[0,3],[12,3]]

}
