{
"row":13,
"col":7,
"isloop":0,
"interlude":1,
"group":1,
"datas":[2,2,2,2,2,1,1,1,2,2,2,2,2,
2,2,2,2,2,1,2,1,2,2,2,2,2,
2,2,2,2,0,1,2,1,2,2,2,2,2,
2,2,1,1,1,1,2,1,1,1,1,2,2,
2,2,2,2,2,1,2,1,2,2,0,2,2,
2,2,2,2,2,1,2,1,2,2,2,2,2,
2,2,2,2,2,1,1,1,2,2,2,2,2],

"it1":[0,0,0,0,0,0,0,0,0,0,0,0,0,
0,0,0,0,0,0,0,0,0,0,0,0,0,
0,0,0,0,0,0,0,0,0,0,0,0,0,
0,0,0,0,0,0,425,0,0,0,0,0,0,
0,0,0,0,0,0,0,0,0,0,0,0,0,
0,0,0,0,0,0,0,0,0,0,0,0,0,
0,0,0,0,0,0,0,0,0,0,0,0,0],

"it2":[0,0,0,0,0,0,0,0,0,0,0,0,0,
0,0,0,0,0,0,0,0,0,0,0,0,0,
0,0,0,0,0,0,0,0,0,0,0,0,0,
0,0,0,0,0,0,3012,0,0,0,0,0,0,
0,0,0,0,0,0,0,0,0,0,0,0,0,
0,0,0,0,0,0,0,0,0,0,0,0,0,
0,0,0,0,0,0,0,0,0,0,0,0,0],

"point1": [[2,3],[5,3],[5,6],[7,6],[7,3],[10,3]],
"point2": [[2,3],[5,3],[5,0],[7,0],[7,3],[10,3]]

}
