{
"row":13,
"col":7,
"isloop":0,
"datas":[2,2,2,3,2,3,3,3,3,3,3,3,3,
2,2,2,2,2,3,2,2,3,2,2,2,3,
2,2,1,3,3,3,2,3,3,2,3,3,3,
2,2,0,2,2,3,2,2,3,2,2,2,3,
2,2,2,3,2,3,2,3,3,3,3,2,3,
2,2,2,2,2,3,2,2,3,2,2,2,3,
1,3,3,3,3,3,3,3,3,3,3,3,3],

"it1":[434,0,430,0,427,0,0,0,0,0,0,0,0,
0,0,0,429,0,0,429,0,0,426,0,423,0,
428,403,0,0,0,0,428,0,0,421,0,0,0,
429,0,0,429,0,0,426,0,0,429,0,424,0,
434,0,431,0,427,0,428,0,0,0,0,421,0,
0,0,0,426,0,0,429,0,0,429,0,423,0,
0,0,0,0,0,0,0,0,0,0,0,0,0],

"it2":[],

"point1": [[0,6],[2,2]],
"point2": [[0,6],[2,2]],
"point3": [[0,6],[2,2]],
"point4": [[0,6],[2,2]]

}
