{
"row":13,
"col":7,
"isloop":0,
"destroyed1":[[0,5],[2,5]],
"destroyed2":[[0,5],[2,5]],
"destroyed3":[[11,5],[10,5]],
"destroyed4":[[11,5],[10,5]],
"datas":[1,1,1,1,1,1,1,1,1,1,1,1,1,
1,2,2,2,2,2,0,2,2,2,2,2,1,
1,2,2,2,2,2,2,2,2,2,2,2,1,
1,1,1,1,1,1,2,1,1,1,1,1,1,
2,2,2,2,2,1,2,1,2,2,2,2,2,
2,2,1,1,1,1,2,1,1,1,1,2,2,
2,2,2,2,2,2,2,2,2,2,2,2,2],

"it1":[0,0,0,0,0,0,0,0,0,0,0,0,0,
0,406,0,425,451,0,0,451,0,425,406,0,0,
0,0,0,8021,0,0,443,0,0,0,0,0,0,
0,0,0,0,0,0,443,0,0,0,0,0,0,
449,0,425,0,8021,0,446,0,0,0,425,449,0,
400,0,0,0,0,0,0,0,0,0,0,400,0,
0,0,449,0,448,0,401,448,0,449,0,0,0],

"it2":[0,0,0,0,0,0,0,0,0,0,0,0,0,
0,0,0,3011,0,0,0,0,0,3011,0,0,0,
0,0,0,0,0,0,0,0,0,0,0,0,0,
0,0,0,0,0,0,0,0,0,0,0,0,0,
0,0,3011,0,0,0,0,0,0,0,3011,0,0,
0,0,0,0,0,0,0,0,0,0,0,0,0,
0,0,0,0,0,0,0,0,0,0,0,0,0],

"point1": [[2,5],[5,5],[5,3],[0,3],[0,0],[6,0]],
"point2": [[2,5],[5,5],[5,3],[0,3],[0,0],[6,0]],
"point3": [[10,5],[7,5],[7,3],[12,3],[12,0],[6,0]],
"point4": [[10,5],[7,5],[7,3],[12,3],[12,0],[6,0]]

}
