{
"row":13,
"col":7,
"isloop":1,
"datas":[2,2,2,2,2,2,2,2,2,2,2,2,2,
1,1,1,1,1,1,2,1,1,1,1,1,1,
1,2,2,2,2,1,2,1,2,2,2,2,1,
1,2,2,2,2,1,2,1,2,2,2,2,1,
1,2,2,2,2,1,2,1,2,2,2,2,1,
1,1,1,1,1,1,2,1,1,1,1,1,1,
2,2,2,2,2,2,2,2,2,2,2,2,2],

"it1":[449,0,448,0,447,0,446,449,0,448,0,447,0,
0,0,0,0,0,0,0,0,0,0,0,0,0,
0,449,0,447,0,0,441,0,447,0,449,0,0,
0,441,8011,8011,443,0,443,0,443,0,0,441,0,
0,447,0,449,0,0,442,0,449,0,447,0,0,
0,0,0,0,0,0,446,0,0,0,0,0,0,
447,0,448,0,449,0,0,447,0,448,0,449,0],

"it2":[],

"point1": [[0,5],[5,5],[5,1],[0,1],[0,5]],
"point2": [[0,5],[5,5],[5,1],[0,1],[0,5]],
"point3": [[7,5],[12,5],[12,1],[7,1],[7,5]],
"point4": [[7,5],[12,5],[12,1],[7,1],[7,5]]

}
