{
"row":13,
"col":7,
"isloop":0,
"datas":[2,2,2,2,2,2,2,2,2,2,2,2,2,
2,2,2,2,2,2,2,2,2,2,2,2,2,
2,2,2,2,2,1,1,1,1,1,1,2,2,
2,1,1,1,2,1,2,2,2,2,2,2,2,
2,0,2,1,2,1,2,2,2,2,2,2,2,
2,2,2,1,1,1,2,2,2,2,2,2,2,
2,2,2,2,2,2,2,2,2,2,2,2,2],

"it1":[426,0,432,429,0,433,0,426,0,423,432,433,0,
432,423,0,434,0,0,0,423,426,0,0,0,0,
0,429,0,0,0,0,0,0,0,0,0,423,431,
0,0,0,0,432,0,429,0,422,0,429,0,0,
427,0,432,0,0,0,426,0,421,434,0,421,0,
432,432,0,0,0,0,434,0,423,0,0,427,430,
0,0,426,0,426,0,0,0,427,427,421,0,0],

"it2":[0,0,0,0,0,0,0,0,0,0,0,0,0,
0,0,0,0,0,0,0,0,0,0,0,0,0,
0,0,0,0,0,0,0,0,0,0,0,0,0,
0,0,0,0,0,0,2031,0,0,0,0,0,0,
0,0,0,0,0,0,0,0,0,0,0,0,0,
0,0,0,0,0,0,0,0,0,0,0,0,0,
0,0,0,0,0,0,0,0,0,0,0,0,0],

"point1": [[10,2],[5,2],[5,5],[3,5],[3,3],[1,3]],
"point2": [[10,2],[5,2],[5,5],[3,5],[3,3],[1,3]]

}
