{
"row":13,
"col":7,
"isloop":0,
"datas":[2,2,2,1,1,1,1,1,1,1,1,2,2,
2,2,1,1,2,2,2,2,2,2,1,2,2,
2,2,1,2,2,2,2,2,2,2,1,2,2,
1,1,1,1,1,1,1,1,1,1,1,1,1,
2,2,1,2,2,2,2,2,2,2,1,2,0,
2,2,1,2,2,2,2,2,2,1,1,2,2,
2,2,1,1,1,1,1,1,1,1,2,2,2],

"it1":[429,0,0,0,0,0,0,0,0,0,0,429,0,
434,0,0,0,429,0,432,428,432,430,0,423,427,
0,0,0,425,422,0,0,423,0,0,0,426,0,
0,0,0,0,0,0,0,0,0,0,0,0,0,
434,0,0,425,403,434,0,422,0,421,0,0,0,
0,0,0,429,0,0,0,429,0,0,0,433,0,
429,0,0,0,0,0,0,0,0,0,423,0,0],

"it2":[0,0,0,0,0,0,0,0,0,0,0,0,0,
0,0,0,0,0,0,0,0,0,0,0,0,0,
0,0,0,3021,0,0,0,0,0,0,0,0,0,
0,0,0,0,0,0,0,0,0,0,0,0,0,
0,0,0,5021,0,0,0,0,0,0,0,0,0,
0,0,0,0,0,0,0,0,0,0,0,0,0,
0,0,0,0,0,0,0,0,0,0,0,0,0],

"point1": [[0,3],[12,3]],
"point2": [[0,3],[12,3]],
"point3": [[0,3],[2,3],[2,6],[9,6],[9,5],[10,5],[10,3],[12,3]],
"point4": [[0,3],[2,3],[2,1],[3,1],[3,0],[10,0],[10,3],[12,3]]

}
