{
"row":13,
"col":7,
"isloop":0,
"destroyed1":[[0,5],[2,6]],
"destroyed2":[[11,0],[10,0]],
"datas":[1,1,1,1,1,2,2,2,2,2,1,2,2,
2,2,2,2,1,1,1,1,1,1,1,2,2,
2,2,2,2,1,2,2,2,2,2,2,2,2,
2,2,2,2,1,1,1,1,1,2,2,2,2,
2,2,2,2,2,2,0,2,1,2,2,2,2,
2,2,1,1,1,1,1,1,1,2,2,2,2,
2,2,1,2,2,2,2,2,1,1,1,1,1],

"it1":[0,0,0,0,0,429,0,427,422,0,0,400,0,
432,430,434,0,0,0,0,0,0,0,0,0,0,
0,0,0,0,0,423,0,426,0,430,432,433,0,
433,0,432,430,0,0,0,0,0,0,0,0,0,
0,0,0,0,426,0,0,0,0,434,0,430,432,
400,0,0,0,0,0,0,0,0,0,0,0,0,
0,0,0,422,0,427,429,0,0,0,0,0,0],

"it2":[0,0,0,0,0,0,0,0,0,0,0,0,0,
0,0,7011,7031,0,0,0,0,0,0,0,0,0,
0,0,7011,7011,0,0,0,0,0,0,0,0,0,
0,0,0,0,0,0,0,0,0,0,0,0,0,
0,0,0,0,0,0,0,0,0,7011,7011,0,0,
0,0,0,0,0,0,0,0,0,7031,7011,0,0,
0,0,0,0,0,0,0,0,0,0,0,0,0],

"point1": [[2,6],[2,5],[8,5],[8,3],[6,3]],
"point2": [[12,6],[8,6],[8,3],[6,3]],
"point3": [[10,0],[10,1],[4,1],[4,3],[6,3]],
"point4": [[0,0],[4,0],[4,3],[6,3]]

}
