{
"row":13,
"col":7,
"isloop":0,
"datas":[2,2,2,2,2,2,2,2,2,2,2,2,2,
2,2,2,1,1,1,1,1,1,1,2,2,2,
2,2,2,1,2,2,2,2,2,1,2,2,2,
2,2,2,1,2,2,2,2,2,1,2,2,2,
2,2,2,1,2,2,2,2,2,1,2,2,2,
2,2,2,2,1,1,1,1,1,1,2,2,2,
2,2,2,2,0,2,2,2,2,2,2,2,2],

"it1":[434,0,429,0,426,0,429,0,426,0,429,0,0,
0,0,403,0,0,0,0,0,0,0,432,433,0,
430,429,0,0,423,427,432,433,0,0,0,0,0,
0,424,427,0,434,0,0,0,0,0,429,0,0,
423,429,0,0,0,0,429,0,428,0,430,424,423,
432,403,434,0,0,0,0,0,0,0,0,429,0,
0,427,0,0,0,426,0,429,0,0,423,429,0],

"it2":[0,0,0,0,0,0,0,0,0,0,0,0,0,
0,0,0,0,0,0,0,0,0,0,0,0,0,
0,0,0,0,0,0,0,0,0,0,0,0,0,
0,0,0,0,0,0,0,0,0,0,0,0,0,
0,0,0,0,0,0,0,0,0,0,0,0,0,
0,0,0,6031,0,0,0,0,0,0,0,0,0,
0,0,0,0,0,0,0,0,0,0,0,0,0],

"point1": [[3,4],[3,1],[9,1],[9,5],[4,5]],
"point2": [[3,4],[3,1],[9,1],[9,5],[4,5]]

}
