{
"row":13,
"col":7,
"isloop":0,
"datas":[2,2,2,2,2,2,1,2,2,2,2,2,2,
2,2,2,2,2,2,1,2,2,2,2,2,2,
1,1,1,1,1,1,1,1,1,1,1,1,1,
1,2,2,2,1,2,1,2,1,2,2,2,1,
1,2,2,2,1,2,1,2,1,2,2,2,1,
1,2,2,2,1,2,1,2,1,2,2,2,1,
1,1,1,1,1,2,0,2,1,1,1,1,1],

"it1":[0,434,0,432,434,0,0,434,0,432,434,0,0,
0,0,0,0,0,0,0,0,0,0,0,0,0,
0,0,0,0,0,0,0,0,0,0,0,0,0,
0,429,0,432,0,431,0,431,0,432,429,0,0,
0,432,403,0,0,0,0,0,0,0,403,432,0,
0,0,429,0,0,423,0,423,0,429,0,0,0,
0,0,0,0,0,0,0,0,0,0,0,0,0],

"it2":[0,0,0,0,0,0,0,0,0,0,0,0,0,
0,0,0,0,2011,4031,0,4031,2011,0,0,0,0,
0,0,0,0,0,0,0,0,0,0,0,0,0,
0,0,0,0,0,0,0,0,0,0,0,0,0,
0,0,0,0,0,0,0,0,0,0,0,0,0,
0,0,0,0,0,0,0,0,0,0,0,0,0,
0,0,0,0,0,0,0,0,0,0,0,0,0],

"point1": [[6,0],[6,5]],
"point2": [[6,0],[6,5]],
"point3": [[4,3],[4,6],[0,6],[0,2],[6,2],[6,5]],
"point4": [[8,3],[8,6],[12,6],[12,2],[6,2],[6,5]]

}
