{
"row":13,
"col":7,
"isloop":0,
"datas":[2,2,2,2,2,2,2,2,2,2,2,2,2,
2,1,1,2,2,2,2,2,2,2,2,2,2,
2,1,1,1,1,1,1,1,1,1,1,1,2,
2,1,2,2,2,2,2,2,2,2,2,1,2,
2,1,2,1,1,1,1,1,1,1,1,1,2,
2,2,2,0,2,2,2,2,2,2,1,1,2,
2,2,2,2,2,2,2,2,2,2,2,2,2],

"it1":[423,422,0,432,434,0,430,432,0,429,0,434,0,
432,0,0,0,0,0,0,0,423,427,423,0,0,
0,0,0,0,0,0,0,0,0,0,0,0,430,
430,0,425,422,0,426,0,421,426,0,425,0,0,
0,0,432,0,0,0,0,0,0,0,0,0,432,
434,0,0,0,423,432,0,434,0,423,0,0,0,
0,0,429,0,423,0,427,0,0,422,0,429,0],

"it2":[0,0,0,0,0,0,0,0,0,0,0,0,0,
0,0,0,0,0,0,0,0,0,0,0,0,0,
0,0,0,0,0,0,0,0,0,0,0,0,0,
0,0,5031,0,0,0,0,0,0,0,2021,0,0,
0,0,0,0,0,0,0,0,0,0,0,0,0,
0,0,0,0,0,0,0,0,0,0,0,0,0,
0,0,0,0,0,0,0,0,0,0,0,0,0],

"point1": [[1,4],[1,1],[2,1],[2,2],[11,2],[11,5],[10,5],[10,4],[3,4]],
"point2": [[1,4],[1,1],[2,1],[2,2],[11,2],[11,5],[10,5],[10,4],[3,4]],
"point3": [[1,4],[1,1],[2,1],[2,2],[11,2],[11,5],[10,5],[10,4],[3,4]]

}
