{
"row":13,
"col":7,
"isloop":1,
"datas":[2,2,2,2,2,2,2,2,2,2,2,2,2,
1,1,1,1,1,1,1,1,1,1,1,1,2,
1,2,2,2,2,2,2,2,2,2,2,1,2,
1,1,1,1,1,1,1,1,1,1,1,1,1,
2,1,2,2,2,2,2,2,2,2,2,2,1,
2,1,1,1,1,1,1,1,1,1,1,1,1,
2,2,2,2,2,2,2,2,2,2,2,2,2],

"it1":[422,0,428,0,426,0,428,426,0,428,0,422,0,
0,0,0,0,0,0,0,0,0,0,0,0,432,
0,424,429,0,423,429,0,424,429,0,424,0,0,
0,0,0,0,0,0,0,0,0,0,0,0,0,
432,0,429,0,427,426,0,426,0,427,429,0,0,
0,0,0,0,0,0,0,0,0,0,0,0,0,
429,0,426,0,429,0,428,429,0,426,0,429,0],

"it2":[0,0,0,0,0,0,0,0,0,0,0,0,0,
0,0,0,0,0,0,0,0,0,0,0,0,0,
0,0,0,0,0,0,0,0,0,0,0,0,0,
0,0,0,0,0,0,0,0,0,0,0,0,0,
0,0,0,0,0,0,0,0,0,0,0,0,0,
0,0,0,0,0,0,0,0,0,0,0,0,0,
0,3011,0,0,3011,0,0,0,3011,0,0,3011,0],

"point1": [[0,1],[11,1],[11,3],[0,3],[0,1]],
"point2": [[12,5],[1,5],[1,3],[12,3],[12,5]]

}
