{
"row":13,
"col":7,
"isloop":0,
"datas":[2,2,2,2,2,1,1,1,2,2,2,2,2,
2,2,2,2,2,1,0,1,2,2,2,2,2,
2,2,2,2,1,1,2,1,1,2,2,2,2,
2,2,2,1,1,2,2,2,1,1,2,2,2,
2,2,2,1,2,2,2,2,2,1,2,2,2,
1,1,1,1,2,2,2,2,2,1,1,1,1,
2,2,2,2,2,2,2,2,2,2,2,2,2],

"it1":[472,401,472,479,0,0,0,0,479,0,472,401,472,
471,476,477,476,475,0,0,0,472,475,476,477,471,
471,0,0,0,0,0,0,0,0,475,0,0,471,
0,479,0,0,0,475,473,475,0,0,479,0,0,
481,0,475,0,481,0,478,481,0,0,475,481,0,
0,0,0,0,481,0,0,481,0,0,0,0,0,
471,401,479,0,401,480,0,471,401,479,0,401,471],

"it2":[0,0,0,0,0,0,0,0,0,0,0,0,0,
0,0,0,0,0,0,0,0,0,0,0,0,0,
0,0,0,0,0,0,0,0,0,0,0,0,0,
0,0,0,0,0,0,0,0,0,0,0,0,0,
0,0,3011,0,0,0,0,0,0,0,3011,0,0,
0,0,0,0,0,0,0,0,0,0,0,0,0,
0,0,0,0,0,0,0,0,0,0,0,0,0],

"point1": [[12,5],[9,5],[9,3],[8,3],[8,2],[7,2],[7,0],[6,0]],
"point2": [[0,5],[3,5],[3,3],[4,3],[4,2],[5,2],[5,0],[6,0]],
"point3": [[12,5],[9,5],[9,3],[8,3],[8,2],[7,2],[7,0],[6,0]],
"point4": [[0,5],[3,5],[3,3],[4,3],[4,2],[5,2],[5,0],[6,0]]

}
