{
"row":13,
"col":7,
"isloop":0,
"datas":[2,2,2,2,2,2,2,2,1,1,2,2,2,
2,2,1,1,1,2,2,2,1,1,2,2,2,
2,1,1,2,1,1,1,1,1,1,1,1,1,
1,1,2,2,2,2,2,2,2,2,2,2,2,
0,1,1,2,1,1,1,1,1,1,1,1,1,
2,2,1,1,1,2,2,2,1,1,2,2,2,
2,2,2,2,2,2,2,2,1,1,2,2,2],

"it1":[479,0,472,473,474,483,0,471,0,0,483,0,478,
473,0,0,0,0,0,0,475,0,0,0,0,0,
475,0,0,475,0,0,0,0,0,0,0,0,0,
0,0,475,425,475,475,475,475,401,401,473,474,475,
0,0,0,475,0,0,0,0,0,0,0,0,0,
475,0,0,0,0,483,0,475,0,0,483,0,478,
479,0,475,481,0,0,0,471,0,0,0,0,0],

"it2":[0,0,0,0,0,0,0,0,0,0,0,0,0,
0,0,0,0,0,5011,5011,0,0,0,0,0,0,
0,0,0,0,0,0,0,0,0,0,0,0,0,
0,0,0,4031,0,0,0,0,0,0,0,0,0,
0,0,0,0,0,0,0,0,0,0,0,0,0,
0,0,0,0,0,5011,5011,0,0,0,0,0,0,
0,0,0,0,0,0,0,0,0,0,0,0,0],

"point1": [[12,4],[9,4],[9,6],[8,6],[8,4],[4,4],[4,5],[2,5],[2,4],[1,4],[1,3],[0,3]],
"point2": [[12,2],[9,2],[9,0],[8,0],[8,2],[4,2],[4,1],[2,1],[2,2],[1,2],[1,3],[0,3]],
"point3": [[12,4],[9,4],[9,6],[8,6],[8,4],[4,4],[4,5],[2,5],[2,4],[1,4],[1,3],[0,3]],
"point4": [[12,2],[9,2],[9,0],[8,0],[8,2],[4,2],[4,1],[2,1],[2,2],[1,2],[1,3],[0,3]]

}
