{
"row":13,
"col":7,
"isloop":0,
"datas":[2,2,2,2,1,1,2,1,1,2,2,2,2,
2,2,1,1,1,1,2,1,1,1,1,2,2,
1,1,1,2,2,1,2,1,2,2,1,1,1,
1,2,2,2,2,1,2,1,2,2,2,2,1,
2,2,2,2,2,1,2,1,2,2,2,2,0,
2,2,2,2,2,1,1,1,2,2,2,2,2,
2,2,2,2,2,2,2,2,2,2,2,2,2],

"it1":[479,0,479,0,0,0,425,0,0,479,0,401,477,
0,0,0,0,0,0,473,0,0,0,0,471,0,
0,0,0,473,473,0,474,0,478,476,0,0,0,
0,479,0,475,472,0,473,0,0,0,479,0,0,
471,471,475,471,471,0,473,0,471,480,0,471,0,
476,477,477,481,0,0,0,0,478,477,476,473,401,
0,0,0,480,0,425,474,425,0,0,0,479,0],

"it2":[0,0,0,0,0,0,3031,0,0,0,0,0,0,
0,0,0,0,0,0,0,0,0,0,0,0,0,
0,0,0,0,0,0,0,0,0,0,0,0,0,
0,0,0,0,0,0,0,0,0,0,0,0,0,
0,0,0,0,0,0,0,0,0,0,0,0,0,
0,0,0,0,0,0,0,0,0,0,0,0,0,
0,0,0,0,0,6021,0,6021,0,0,0,0,0],

"point1": [[0,3],[0,2],[2,2],[2,1],[4,1],[4,0],[5,0],[5,5],[7,5],[7,0],[8,0],[8,1],[10,1],[10,2],[12,2],[12,3]],
"point2": [[0,3],[0,2],[2,2],[2,1],[4,1],[4,0],[5,0],[5,5],[7,5],[7,0],[8,0],[8,1],[10,1],[10,2],[12,2],[12,3]]

}
