{
"row":13,
"col":7,
"isloop":0,
"datas":[2,1,2,2,1,2,2,2,1,2,2,1,1,
2,1,2,2,1,2,2,2,1,2,2,1,0,
2,1,2,2,1,2,2,2,1,2,2,1,2,
2,1,2,2,1,2,2,2,1,2,2,1,2,
2,1,2,2,1,2,2,2,1,2,2,1,2,
2,1,2,2,1,2,2,2,1,2,2,1,2,
2,1,1,1,1,1,1,1,1,1,1,1,2],

"it1":[478,0,471,478,0,475,483,0,0,471,475,0,0,
0,0,475,0,0,475,0,0,0,479,0,0,0,
0,0,478,471,0,483,0,471,0,475,475,0,478,
0,0,0,475,0,0,0,475,0,479,0,0,0,
0,0,475,478,0,471,483,0,0,475,475,0,478,
478,0,475,0,0,475,0,0,0,479,0,0,0,
0,0,0,0,0,0,0,0,0,0,0,0,0],

"it2":[0,0,1011,0,0,0,0,0,0,1011,0,0,0,
0,0,0,0,0,0,0,0,0,0,0,0,0,
0,0,0,1011,0,0,0,1011,0,0,0,0,2011,
0,0,0,0,0,0,0,0,0,0,0,0,0,
0,0,0,0,0,1011,0,0,0,0,0,0,2011,
0,0,0,0,0,0,0,0,0,0,0,0,0,
0,0,0,0,0,0,0,0,0,0,0,0,0],

"point1": [[1,0],[1,6],[11,6],[11,0],[12,0]],
"point2": [[4,0],[4,6],[11,6],[11,0],[12,0]],
"point3": [[8,0],[8,6],[11,6],[11,0],[12,0]]

}
