{
"row":13,
"col":7,
"isloop":0,
"datas":[2,2,2,2,2,2,2,2,2,2,2,2,2,
2,2,1,1,1,1,2,2,1,1,1,1,2,
2,2,1,2,2,1,2,2,1,2,2,1,2,
1,1,1,2,2,1,1,1,1,2,2,1,1,
2,2,2,2,2,2,2,2,2,2,2,1,0,
1,1,1,1,1,1,1,1,1,1,1,1,2,
2,2,2,2,2,2,2,2,2,2,2,2,2],

"it1":[478,477,0,475,480,0,479,0,479,0,475,0,471,
0,0,0,0,0,0,483,0,0,0,0,0,477,
472,403,0,475,477,0,0,0,0,475,475,0,0,
0,0,0,476,0,0,0,0,0,477,473,0,0,
480,0,471,0,481,0,479,0,475,0,471,0,0,
0,0,0,0,0,0,0,0,0,0,0,0,473,
401,481,0,471,401,472,471,479,0,471,479,0,472],

"it2":[0,0,0,0,0,0,0,0,0,0,0,0,0,
0,0,0,0,0,0,0,0,0,0,0,0,0,
0,0,0,0,0,0,0,0,0,0,0,0,0,
0,0,0,0,0,0,0,0,0,0,0,0,0,
0,0,1011,0,0,0,0,0,0,0,1011,0,0,
0,0,0,0,0,0,0,0,0,0,0,0,0,
0,0,0,1011,0,0,1011,0,0,1011,0,0,0],

"point1": [[0,3],[2,3],[2,1],[5,1],[5,3],[8,3],[8,1],[11,1],[11,3],[12,3]],
"point2": [[0,5],[11,5],[11,3],[12,3]],
"point3": [[0,3],[2,3],[2,1],[5,1],[5,3],[8,3],[8,1],[11,1],[11,3],[12,3]],
"point4": [[0,5],[11,5],[11,3],[12,3]]

}
