{
"row":13,
"col":7,
"isloop":0,
"destroyed1":[[1,3],[1,2]],
"destroyed2":[[1,3],[1,2]],
"datas":[2,2,2,2,2,2,2,2,2,2,2,2,2,
2,2,2,2,2,2,2,2,2,2,2,2,2,
2,1,1,1,1,1,1,1,1,1,1,1,2,
2,2,2,1,1,1,1,1,1,1,1,1,2,
2,2,2,0,2,2,2,2,2,2,2,2,2,
2,2,2,2,2,2,2,2,2,2,2,2,2,
2,2,2,2,2,2,2,2,2,2,2,2,2],

"it1":[401,482,0,476,477,473,473,479,0,425,406,0,472,
478,0,0,0,0,0,475,480,0,471,0,0,477,
0,0,0,0,0,0,0,0,0,0,0,0,0,
476,400,0,0,0,0,0,0,0,0,0,0,473,
0,0,0,0,483,0,481,0,403,478,481,0,477,
479,0,0,401,0,0,472,474,477,0,479,0,0,
480,0,475,480,0,474,481,0,0,479,0,473,471],

"it2":[0,0,0,0,0,0,0,0,0,1011,0,0,0,
0,0,0,0,0,0,0,0,0,0,0,0,0,
0,0,0,0,0,0,0,0,0,0,0,0,0,
0,0,0,0,0,0,0,0,0,0,0,0,0,
0,0,0,0,0,0,0,0,0,0,0,0,0,
0,0,0,0,0,0,0,0,0,0,0,0,0,
0,0,0,0,0,0,0,0,0,0,0,0,0],

"point1": [[1,2],[11,2],[11,3],[3,3]],
"point2": [[1,2],[11,2],[11,3],[3,3]]

}
