{
"row":13,
"col":7,
"isloop":0,
"datas":[2,2,2,2,2,2,2,2,2,2,2,2,2,
2,2,2,2,2,2,2,2,2,2,2,2,2,
1,1,1,1,1,1,1,2,2,2,2,2,2,
1,1,1,2,1,1,1,2,2,2,2,2,2,
2,2,1,2,0,1,1,2,2,2,2,2,2,
2,2,1,2,2,1,1,2,2,2,1,2,2,
2,2,1,1,1,1,1,1,1,1,1,2,2],

"it1":[477,478,483,0,476,473,477,481,0,476,479,0,401,
0,0,0,0,0,0,0,483,0,0,401,482,0,
0,0,0,0,0,0,0,0,0,479,0,0,0,
0,0,0,475,0,0,0,478,401,483,0,476,401,
483,0,0,0,0,0,0,0,478,0,0,0,473,
0,0,0,481,0,0,0,472,0,475,0,481,0,
472,0,0,0,0,0,0,0,0,0,0,479,0],

"it2":[],

"point1": [[10,5],[10,6],[6,6],[6,2],[0,2],[0,3],[2,3],[2,6],[5,6],[5,3],[4,3]],
"point2": [[10,5],[10,6],[6,6],[6,2],[0,2],[0,3],[2,3],[2,6],[5,6],[5,3],[4,3]]

}
