{
"row":13,
"col":7,
"isloop":0,
"datas":[2,2,2,2,2,2,2,2,2,2,2,2,2,
2,1,1,1,1,1,1,2,2,2,2,2,2,
2,1,2,2,2,2,1,2,2,2,2,2,2,
2,1,2,2,2,2,1,2,2,2,2,2,2,
2,1,1,1,1,1,1,1,1,1,1,1,2,
2,2,2,2,2,2,2,2,1,1,1,1,2,
2,2,2,2,2,2,2,2,0,2,2,2,2],

"it1":[479,0,473,472,481,0,475,477,479,0,481,0,471,
477,0,0,0,0,0,0,0,473,476,480,0,478,
0,0,477,483,0,476,0,406,0,0,478,0,0,
472,0,0,0,0,0,0,0,0,471,0,481,0,
401,0,0,0,0,0,0,0,0,0,0,0,478,
483,0,481,0,475,0,477,471,0,0,0,0,0,
0,0,475,0,481,0,0,472,0,472,479,0,471],

"it2":[],

"point1": [[6,3],[6,1],[1,1],[1,4],[11,4],[11,5],[8,5]],
"point2": [[6,3],[6,1],[1,1],[1,4],[11,4],[11,5],[8,5]],
"point3": [[6,3],[6,1],[1,1],[1,4],[11,4],[11,5],[8,5]]

}
