{
"row":13,
"col":7,
"isloop":0,
"datas":[2,2,2,2,2,1,1,1,1,1,1,1,2,
2,2,2,2,2,2,2,2,2,2,2,1,2,
2,2,2,2,2,1,1,1,2,2,2,1,2,
2,2,2,2,2,1,2,1,1,2,2,1,2,
2,2,2,1,1,1,2,2,1,1,2,1,2,
2,2,1,1,2,2,2,1,1,1,1,1,2,
2,2,2,2,2,2,2,0,2,2,2,2,2],

"it1":[476,479,0,482,0,0,0,0,0,0,0,0,0,
0,482,0,0,0,481,0,479,0,483,0,0,477,
477,0,0,483,0,0,0,0,401,0,0,0,0,
0,476,471,0,0,0,478,0,0,475,478,0,401,
473,0,471,0,0,0,0,473,0,0,0,0,476,
482,0,0,0,479,0,472,0,0,0,0,0,0,
0,0,401,481,0,481,0,0,0,475,0,479,0],

"it2":[0,0,0,0,0,0,0,0,0,0,0,0,0,
0,0,0,0,0,0,0,0,0,0,0,0,0,
0,0,0,0,0,0,0,0,0,0,0,0,0,
0,0,2031,0,0,0,0,0,0,0,0,0,0,
0,0,0,0,0,0,0,0,0,0,0,0,0,
0,0,0,0,0,0,0,0,0,0,0,0,0,
0,0,0,0,0,0,0,0,0,0,0,0,0],

"point1": [[2,5],[3,5],[3,4],[5,4],[5,2],[7,2],[7,3],[8,3],[8,4],[9,4],[9,5],[7,5]],
"point2": [[2,5],[3,5],[3,4],[5,4],[5,2],[7,2],[7,3],[8,3],[8,4],[9,4],[9,5],[7,5]],
"point3": [[5,0],[11,0],[11,5],[7,5]],
"point4": [[5,0],[11,0],[11,5],[7,5]]

}
