{
"row":13,
"col":7,
"isloop":0,
"datas":[2,2,1,1,1,1,1,1,1,1,2,2,2,
2,2,1,2,2,2,2,2,2,1,2,2,2,
2,2,1,2,2,2,1,1,2,1,2,2,2,
2,2,1,2,2,1,1,1,2,1,2,2,2,
2,2,1,2,2,1,1,1,1,1,2,2,2,
2,2,1,2,2,1,1,2,1,1,2,2,2,
2,2,1,1,1,1,1,1,1,0,2,2,2],

"it1":[476,0,0,0,0,0,0,0,0,0,478,480,0,
0,478,0,475,483,0,472,481,0,0,0,406,0,
401,0,0,476,0,0,0,0,478,0,475,0,0,
482,0,0,0,475,0,0,0,0,0,476,479,0,
0,0,0,483,0,0,0,0,0,0,0,473,478,
0,478,0,0,0,0,0,425,0,0,482,0,0,
474,0,0,0,0,0,0,0,0,0,0,0,472],

"it2":[0,0,0,0,0,0,0,0,0,0,0,0,0,
0,0,0,0,0,0,0,0,0,0,0,0,0,
0,0,0,0,0,0,0,0,0,0,0,0,0,
0,0,0,0,0,0,0,0,3021,0,0,0,0,
0,0,0,0,0,0,0,0,0,0,0,0,0,
0,0,0,0,0,0,0,2021,0,0,0,0,0,
0,0,0,0,0,0,0,0,0,0,0,0,0],

"point1": [[6,4],[6,6],[8,6],[8,4],[7,4],[7,2],[6,2],[6,3],[5,3],[5,6],[2,6],[2,0],[9,0],[9,5]],
"point2": [[6,4],[6,6],[8,6],[8,4],[7,4],[7,2],[6,2],[6,3],[5,3],[5,6],[2,6],[2,0],[9,0],[9,5]],
"point3": [[6,4],[6,6],[8,6],[8,4],[7,4],[7,2],[6,2],[6,3],[5,3],[5,6],[2,6],[2,0],[9,0],[9,5]]

}
