{
"row":13,
"col":7,
"isloop":0,
"datas":[2,2,1,1,1,1,1,1,2,2,2,2,2,
2,1,1,2,2,2,2,1,1,2,2,2,2,
1,1,2,2,2,2,2,2,1,1,2,2,2,
2,2,2,2,2,2,2,2,2,1,1,1,1,
1,1,2,2,2,2,2,2,1,1,2,2,0,
2,1,1,2,2,2,2,1,1,2,2,2,2,
2,2,1,1,1,1,1,1,2,2,2,2,2],

"it1":[479,0,0,0,0,0,0,0,480,0,481,0,401,
471,0,0,472,482,0,472,0,0,425,483,0,476,
0,0,0,472,0,0,471,0,0,0,0,0,0,
471,471,479,0,479,0,479,0,475,0,0,0,0,
0,0,0,472,482,0,472,0,0,0,483,0,0,
471,0,0,472,0,0,471,0,0,425,0,0,471,
479,0,0,0,0,0,0,0,480,0,481,0,401],

"it2":[0,0,0,0,0,0,0,0,0,0,0,0,0,
0,0,0,0,0,0,0,0,0,2011,0,0,0,
0,0,0,0,0,0,0,0,0,0,0,0,0,
0,0,0,0,0,0,0,0,0,0,0,0,0,
0,0,0,0,0,0,0,0,0,0,0,0,0,
0,0,0,0,0,0,0,0,0,2011,0,0,0,
0,0,0,0,0,0,0,0,0,0,0,0,0],

"point1": [[0,4],[1,4],[1,5],[2,5],[2,6],[7,6],[7,5],[8,5],[8,4],[9,4],[9,3],[12,3]],
"point2": [[0,2],[1,2],[1,1],[2,1],[2,0],[7,0],[7,1],[8,1],[8,2],[9,2],[9,3],[12,3]],
"point3": [[0,4],[1,4],[1,5],[2,5],[2,6],[7,6],[7,5],[8,5],[8,4],[9,4],[9,3],[12,3]],
"point4": [[0,2],[1,2],[1,1],[2,1],[2,0],[7,0],[7,1],[8,1],[8,2],[9,2],[9,3],[12,3]]

}
