{
"row":13,
"col":7,
"isloop":0,
"datas":[1,1,1,2,2,2,2,2,2,2,1,1,1,
1,2,1,2,2,2,2,2,2,2,1,2,1,
1,2,1,1,1,2,2,2,1,1,1,2,1,
1,1,1,1,1,1,1,1,1,1,1,1,1,
2,2,1,1,1,2,0,2,1,1,1,2,2,
2,2,1,2,2,2,2,2,2,2,1,2,2,
1,1,1,2,2,2,2,2,2,2,1,1,1],

"it1":[0,0,0,401,479,0,471,479,0,401,0,0,0,
0,472,0,473,481,0,478,481,0,473,0,472,0,
0,425,0,0,0,0,0,0,0,0,0,425,0,
0,0,0,0,0,0,0,0,0,0,0,0,0,
472,425,0,0,0,474,0,474,0,0,0,425,472,
401,475,0,482,0,471,425,477,482,0,0,475,401,
0,0,0,0,0,480,0,0,0,0,0,0,0],

"it2":[0,0,0,0,0,0,0,0,0,0,0,0,0,
0,0,0,0,0,0,0,0,0,0,0,0,0,
0,4031,0,0,0,0,0,0,0,0,0,4031,0,
0,0,0,0,0,0,0,0,0,0,0,0,0,
0,4041,0,0,0,0,0,0,0,0,0,4041,0,
0,0,0,0,0,0,1021,0,0,0,0,0,0,
0,0,0,0,0,0,0,0,0,0,0,0,0],

"point1": [[0,6],[2,6],[2,4],[4,4],[4,2],[2,2],[2,0],[0,0],[0,3],[6,3]],
"point2": [[12,6],[10,6],[10,4],[8,4],[8,2],[10,2],[10,0],[12,0],[12,3],[6,3]],
"point3": [[0,6],[2,6],[2,4],[4,4],[4,2],[2,2],[2,0],[0,0],[0,3],[6,3]],
"point4": [[12,6],[10,6],[10,4],[8,4],[8,2],[10,2],[10,0],[12,0],[12,3],[6,3]]

}
