{
"row":13,
"col":7,
"isloop":0,
"destroyed1":[[5,2],[5,1]],
"destroyed2":[[5,2],[5,1]],
"datas":[2,2,2,2,2,2,2,2,2,2,2,2,2,
2,1,1,2,2,1,1,1,1,2,2,2,2,
2,0,1,2,2,2,2,2,1,2,2,2,2,
2,2,1,2,2,2,2,2,1,2,2,2,2,
2,2,1,2,2,2,2,2,1,2,2,2,2,
2,2,1,1,1,1,1,1,1,2,2,2,2,
2,2,2,2,2,2,2,2,2,2,2,2,2],

"it1":[471,479,0,472,479,0,474,480,0,479,0,471,476,
475,0,0,479,0,0,0,0,0,406,0,425,0,
1011,0,0,478,475,400,0,475,0,0,0,476,475,
482,0,0,0,472,0,0,477,0,481,0,0,0,
0,0,0,401,475,481,0,0,0,481,0,471,476,
476,477,0,0,0,0,0,0,0,403,482,0,0,
0,0,479,0,481,0,474,480,0,475,0,0,401],

"it2":[0,0,0,0,0,0,0,0,0,0,0,0,0,
0,0,0,0,0,0,0,0,0,0,0,2041,0,
0,0,0,0,0,0,0,0,0,0,0,0,0,
0,0,0,0,0,0,0,0,0,0,0,0,0,
0,0,0,0,0,0,0,0,0,0,0,0,0,
0,0,0,0,0,0,0,0,0,0,0,0,0,
0,0,0,0,0,0,0,0,0,0,0,0,0],

"point1": [[5,1],[8,1],[8,5],[2,5],[2,1],[1,1]],
"point2": [[5,1],[8,1],[8,5],[2,5],[2,1],[1,1]]

}
