{
"row":13,
"col":7,
"isloop":0,
"interlude":1,
"group":2,
"datas":[0,0,0,0,0,0,0,0,0,0,0,0,0,
2,2,1,1,1,2,2,2,1,1,1,1,2,
2,2,1,2,1,2,2,2,1,0,0,2,2,
2,2,1,1,1,1,1,1,1,1,1,2,2,
2,2,0,0,1,2,0,2,1,2,1,2,2,
2,1,1,1,1,2,2,2,1,1,1,2,2,
0,0,0,0,0,0,0,0,0,0,0,0,0],

"it1":[0,0,0,0,0,0,0,0,0,0,0,0,0,
0,0,0,0,0,0,0,0,0,0,0,0,0,
0,0,0,4013,0,0,0,0,0,0,0,0,0,
0,425,0,0,0,0,0,0,0,0,0,425,0,
0,0,0,0,0,0,0,0,0,4013,0,0,0,
0,0,0,0,0,0,0,0,0,0,0,0,0,
0,0,0,0,0,0,0,0,0,0,0,0,0],

"it2":[0,0,0,0,0,0,0,0,0,0,0,0,0,
0,0,0,0,0,0,0,0,0,0,0,0,0,
0,0,0,0,0,0,0,0,0,0,0,0,0,
0,6012,0,0,0,0,0,0,0,0,0,6012,0,
0,0,0,0,0,0,0,0,0,0,0,0,0,
0,0,0,0,0,0,0,0,0,0,0,0,0,
0,0,0,0,0,0,0,0,0,0,0,0,0],

"point1": [[1,5],[4,5],[4,1],[2,1],[2,3],[6,3]],
"point2": [[1,5],[4,5],[4,1],[2,1],[2,3],[6,3]],
"point3": [[11,1],[8,1],[8,5],[10,5],[10,3],[6,3]],
"point4": [[11,1],[8,1],[8,5],[10,5],[10,3],[6,3]]

}
