{
"row":13,
"col":7,
"isloop":0,
"datas":[2,2,1,1,1,1,2,2,2,2,2,2,2,
2,2,1,2,2,1,2,2,2,2,2,2,2,
2,2,1,2,2,1,2,2,2,2,2,2,2,
2,2,1,2,2,1,2,2,2,2,2,2,2,
2,2,1,2,2,1,2,2,2,2,2,2,2,
2,2,1,1,1,1,1,2,2,2,2,2,2,
1,1,1,0,1,1,1,2,2,2,2,2,2],

"it1":[471,475,0,0,0,0,475,471,473,479,0,479,0,
475,0,0,482,0,0,478,471,473,483,0,482,0,
471,478,0,0,0,0,0,473,473,0,0,0,0,
477,0,0,475,478,0,477,475,471,483,0,482,0,
0,475,0,475,0,0,0,479,0,0,0,0,0,
471,401,0,0,0,0,0,471,475,483,0,482,0,
0,0,0,0,0,0,0,473,471,0,0,0,0],

"it2":[0,0,0,0,0,0,0,0,0,0,0,0,0,
0,0,0,2011,0,0,0,0,0,0,0,0,0,
0,0,0,0,0,0,0,2011,0,0,0,0,0,
0,0,0,0,0,0,0,0,403,0,0,0,0,
0,0,0,0,0,0,0,0,0,0,0,0,0,
6011,0,0,0,0,0,0,2011,0,0,0,0,0,
0,0,0,0,0,0,0,0,0,0,0,0,0],

"point1": [[0,6],[2,6],[2,0],[5,0],[5,5],[6,5],[6,6],[4,6],[4,5],[3,5]],
"point2": [[0,6],[2,6],[2,0],[5,0],[5,5],[6,5],[6,6],[4,6],[4,5],[3,5]]

}
