{
"row":13,
"col":7,
"isloop":0,
"datas":[2,2,2,2,2,2,2,2,2,2,2,2,2,
2,2,1,1,1,2,2,2,1,1,1,1,1,
2,2,1,2,1,1,2,2,1,2,1,1,1,
2,2,1,2,2,1,1,2,1,2,1,2,2,
2,2,1,2,2,2,1,2,1,2,1,2,2,
1,1,1,2,2,2,1,1,1,2,1,1,1,
2,2,2,2,2,2,2,2,2,2,2,2,0],

"it1":[472,479,0,472,480,0,475,479,0,0,473,472,473,
478,471,0,0,0,475,483,0,0,0,0,0,0,
0,478,0,473,0,0,0,0,0,476,0,0,0,
478,0,0,480,0,0,0,473,0,0,0,401,401,
0,0,0,483,0,476,0,473,0,476,0,401,401,
0,0,0,0,0,0,0,0,0,0,0,0,0,
479,0,475,472,475,481,0,473,481,0,471,475,0],

"it2":[],

"point1": [[0,5],[2,5],[2,1],[4,1],[4,2],[5,2],[5,3],[6,3],[6,5],[8,5],[8,1],[12,1],[12,2],[10,2],[10,5],[12,5]],
"point2": [[0,5],[2,5],[2,1],[4,1],[4,2],[5,2],[5,3],[6,3],[6,5],[8,5],[8,1],[12,1],[12,2],[10,2],[10,5],[12,5]]

}
