{
"row":13,
"col":7,
"isloop":0,
"datas":[2,2,1,1,1,1,1,1,1,1,1,2,2,
2,2,1,2,2,2,0,2,2,2,1,2,2,
2,2,1,1,1,1,1,1,1,1,1,2,2,
2,2,1,2,2,2,1,2,2,2,1,2,2,
2,1,1,2,2,2,1,2,2,2,1,1,2,
1,1,2,2,2,2,1,2,2,2,2,1,1,
1,2,2,2,2,2,1,2,2,2,2,2,1],

"it1":[482,0,0,0,0,0,0,0,0,0,0,482,0,
0,0,0,0,479,0,0,475,475,0,0,0,0,
482,0,0,0,0,0,0,0,0,0,0,482,0,
0,0,0,482,0,476,0,476,477,475,0,0,0,
471,0,0,0,0,0,0,0,0,478,0,0,471,
0,0,479,0,482,0,0,477,471,0,475,0,0,
0,471,481,0,0,0,0,0,471,481,0,475,0],

"it2":[0,5011,0,0,0,0,0,0,0,0,0,5011,0,
0,5011,0,0,0,0,0,0,0,0,0,5011,0,
0,5011,0,0,0,0,0,0,0,0,0,5011,0,
0,5011,0,0,0,0,0,0,0,0,0,5011,0,
0,0,0,0,0,0,0,0,0,0,0,0,0,
0,0,0,0,0,0,0,0,0,0,0,0,0,
0,0,0,0,0,0,0,0,0,0,0,0,0],

"point1": [[0,6],[0,5],[1,5],[1,4],[2,4],[2,0],[6,0]],
"point2": [[12,6],[12,5],[11,5],[11,4],[10,4],[10,0],[6,0]],
"point3": [[6,6],[6,2],[2,2],[2,0],[6,0]],
"point4": [[6,6],[6,2],[10,2],[10,0],[6,0]]

}
