{
"row":13,
"col":7,
"isloop":0,
"datas":[1,1,1,1,1,1,1,2,1,1,1,1,1,
1,2,2,2,2,2,1,2,0,2,2,2,1,
1,2,2,2,2,2,1,2,2,2,2,2,1,
1,2,2,2,2,2,1,2,2,2,2,2,1,
1,2,2,2,2,2,1,2,2,2,2,2,1,
1,2,2,2,2,2,1,2,2,2,2,2,1,
1,1,1,1,1,2,1,1,1,1,1,1,1],

"it1":[0,0,0,0,0,0,0,1011,0,0,0,0,0,
0,478,481,0,483,0,0,471,0,471,482,0,0,
0,0,479,0,0,0,0,472,479,0,0,0,0,
0,480,0,425,480,0,0,480,0,425,480,0,0,
0,482,0,479,0,478,0,483,0,479,0,0,0,
0,0,0,481,0,0,0,0,0,401,481,0,0,
0,0,0,0,0,401,0,0,0,0,0,0,0],

"it2":[0,0,0,0,0,0,0,0,0,0,0,0,0,
0,0,0,0,0,0,0,0,0,0,0,0,0,
0,0,0,0,0,0,0,0,0,0,0,0,0,
0,0,0,1031,0,0,0,0,0,2041,0,0,0,
0,0,0,0,0,0,0,0,0,0,0,0,0,
0,0,0,0,0,0,0,0,0,0,0,0,0,
0,0,0,0,0,0,0,0,0,0,0,0,0],

"point1": [[4,6],[0,6],[0,0],[6,0],[6,6],[12,6],[12,0],[8,0]],
"point2": [[4,6],[0,6],[0,0],[6,0],[6,6],[12,6],[12,0],[8,0]]

}
