{
"row":13,
"col":7,
"isloop":0,
"datas":[2,2,2,1,1,2,2,2,2,2,2,2,2,
2,2,1,1,1,2,2,2,2,2,2,2,2,
1,1,1,2,1,2,2,2,1,1,1,1,2,
2,2,2,2,1,2,2,2,1,2,2,1,2,
2,1,1,1,1,1,1,1,1,1,1,1,2,
2,1,2,2,1,2,2,2,1,2,2,1,1,
2,1,1,1,1,2,2,2,1,1,1,1,0],

"it1":[476,477,401,0,0,479,0,0,478,473,477,406,0,
0,0,0,0,0,478,480,0,0,475,0,0,0,
0,0,0,471,0,0,477,476,0,0,0,0,478,
473,479,0,472,0,401,0,0,0,481,0,0,0,
425,0,0,0,0,0,0,0,0,0,0,0,475,
475,0,480,0,0,475,480,0,0,474,0,0,0,
401,0,0,0,0,479,0,0,0,0,0,0,0],

"it2":[0,0,0,0,0,0,0,0,0,0,0,0,0,
0,0,0,0,0,0,0,0,0,0,0,0,0,
0,0,0,0,0,0,0,0,0,0,0,0,0,
0,0,0,0,0,0,0,0,0,0,0,0,0,
6021,0,0,0,0,0,0,0,0,0,0,0,0,
0,0,0,0,0,0,0,0,0,0,0,0,0,
0,0,0,0,0,0,0,0,0,0,0,0,0],

"point1": [[0,2],[2,2],[2,1],[3,1],[3,0],[4,0],[4,6],[1,6],[1,4],[11,4],[11,2],[8,2],[8,6],[11,6],[11,5],[12,5]],
"point2": [[0,2],[2,2],[2,1],[3,1],[3,0],[4,0],[4,6],[1,6],[1,4],[11,4],[11,2],[8,2],[8,6],[11,6],[11,5],[12,5]]

}
