{
"row":13,
"col":7,
"isloop":0,
"datas":[2,2,2,2,2,1,1,1,1,1,1,1,2,
1,1,1,1,2,1,2,2,2,2,2,1,2,
1,2,2,1,2,1,2,1,1,1,2,1,2,
1,2,1,1,2,1,2,1,1,1,1,1,2,
1,2,2,2,2,1,2,2,2,1,2,2,2,
1,1,1,1,1,1,2,2,2,1,1,1,1,
2,2,2,2,2,2,2,2,2,2,2,2,0],

"it1":[479,0,481,0,477,0,0,0,0,0,0,0,471,
0,0,0,0,0,0,480,0,0,479,0,0,401,
0,477,425,0,475,0,477,0,0,0,475,0,478,
0,0,0,0,478,0,0,0,0,0,0,0,0,
0,479,0,472,0,0,406,0,471,0,481,0,471,
0,0,0,0,0,0,0,0,478,0,0,0,0,
401,480,0,475,471,471,481,0,0,0,479,0,0],

"it2":[0,0,0,0,0,0,0,0,0,0,0,0,0,
0,0,0,0,0,0,0,0,0,0,0,0,0,
0,0,2021,0,0,0,0,0,0,0,2021,0,0,
0,0,0,0,0,0,0,0,0,0,0,0,0,
0,0,0,0,0,0,0,0,0,0,0,0,0,
0,0,0,0,0,0,0,0,0,0,0,0,0,
0,0,0,0,0,0,0,0,0,0,0,0,0],

"point1": [[2,3],[3,3],[3,1],[0,1],[0,5],[5,5],[5,0],[11,0],[11,3],[7,3],[7,2],[9,2],[9,5],[12,5]],
"point2": [[2,3],[3,3],[3,1],[0,1],[0,5],[5,5],[5,0],[11,0],[11,3],[7,3],[7,2],[9,2],[9,5],[12,5]]

}
