{
"row":13,
"col":7,
"isloop":0,
"datas":[2,1,1,1,2,1,1,1,1,2,2,2,2,
2,1,2,1,1,1,2,2,1,1,2,2,2,
2,1,2,2,2,2,2,2,2,1,2,2,2,
2,1,1,1,1,1,2,2,2,1,2,2,2,
2,2,2,2,2,1,2,2,2,1,2,2,2,
2,1,1,1,1,1,2,2,2,1,1,1,1,
2,2,2,2,2,2,2,2,2,2,2,2,0],

"it1":[506,0,0,0,404,0,0,0,0,404,506,511,0,
0,0,501,0,0,0,511,0,0,0,0,0,0,
505,0,404,509,0,503,0,0,504,0,510,0,503,
0,0,0,0,0,0,500,404,0,0,0,0,506,
505,509,0,500,404,0,511,0,504,0,404,501,0,
0,0,0,0,0,0,0,0,0,0,0,0,0,
507,0,509,0,503,509,0,508,0,0,509,0,0],

"it2":[0,0,0,0,1020,0,0,0,0,902,0,0,0,
0,0,0,0,0,0,0,0,0,0,0,0,0,
0,0,901,0,0,0,0,0,0,0,0,0,0,
0,0,0,0,0,0,0,902,0,0,0,0,0,
0,0,0,0,1370,0,0,0,0,0,901,0,0,
0,0,0,0,0,0,0,0,0,0,0,0,0,
0,0,0,0,0,0,0,0,0,0,0,0,0],

"point1": [[1,5],[5,5],[5,3],[1,3],[1,0],[3,0],[3,1],[5,1],[5,0],[8,0],[8,1],[9,1],[9,5],[12,5]],
"point2": [[1,5],[5,5],[5,3],[1,3],[1,0],[3,0],[3,1],[5,1],[5,0],[8,0],[8,1],[9,1],[9,5],[12,5]],
"point3": [[1,5],[5,5],[5,3],[1,3],[1,0],[3,0],[3,1],[5,1],[5,0],[8,0],[8,1],[9,1],[9,5],[12,5]]

}
