{
"row":13,
"col":7,
"isloop":0,
"datas":[2,2,2,2,1,1,1,1,1,1,1,2,2,
2,2,2,2,1,1,1,1,2,2,1,2,2,
2,1,1,1,1,2,2,1,2,2,1,2,2,
2,1,2,2,1,2,2,1,2,2,1,2,2,
2,1,2,2,1,1,1,1,2,2,1,2,2,
2,1,2,2,2,2,2,2,2,2,1,1,1,
2,2,2,2,2,2,2,2,2,2,2,2,0],

"it1":[401,503,511,0,0,0,0,0,0,0,0,504,500,
500,403,0,0,0,0,0,0,511,0,0,0,506,
506,0,0,0,0,404,404,0,0,0,0,500,0,
0,0,511,0,0,404,404,0,505,506,0,508,0,
504,0,0,0,0,0,0,0,0,0,0,503,0,
0,0,509,0,505,501,503,508,0,506,0,0,0,
508,0,507,0,0,509,0,500,503,0,509,0,0],

"it2":[0,0,0,0,0,0,0,0,0,0,0,0,0,
0,0,0,0,0,0,0,0,0,0,0,0,0,
0,0,0,0,0,1040,1040,0,0,0,0,0,0,
0,0,0,0,0,1040,1040,0,0,0,0,0,0,
0,0,0,0,0,0,0,0,0,0,0,0,0,
0,0,0,0,0,0,0,0,0,0,0,0,0,
0,0,0,0,0,0,0,0,0,0,0,0,0],

"point1": [[1,5],[1,2],[4,2],[4,4],[7,4],[7,1],[4,1],[4,0],[10,0],[10,5],[12,5]],
"point2": [[1,5],[1,2],[4,2],[4,4],[7,4],[7,1],[4,1],[4,0],[10,0],[10,5],[12,5]],
"point3": [[1,5],[1,2],[4,2],[4,4],[7,4],[7,1],[4,1],[4,0],[10,0],[10,5],[12,5]]

}
