{
"row":13,
"col":7,
"isloop":0,
"datas":[2,2,2,2,2,2,2,2,2,2,2,2,2,
1,1,1,2,2,1,1,1,2,2,2,2,2,
2,2,1,2,2,1,2,1,2,1,1,1,2,
2,2,1,2,1,1,2,1,2,1,2,1,2,
2,2,1,1,1,2,2,1,2,1,2,1,1,
2,2,2,2,2,2,2,1,1,1,2,2,1,
2,2,2,2,2,2,2,2,2,2,2,2,0],

"it1":[503,509,0,503,500,500,503,509,0,505,507,0,0,
0,0,0,511,0,0,0,0,504,0,503,503,505,
503,506,0,0,0,0,505,0,0,0,0,0,0,
503,0,0,404,0,0,0,0,503,0,505,0,500,
507,0,0,0,0,500,505,0,503,0,0,0,0,
503,509,0,508,0,505,0,0,0,0,507,0,0,
0,500,509,0,503,0,509,0,500,508,0,500,0],

"it2":[0,0,0,0,0,0,0,0,0,0,0,0,0,
0,0,0,0,0,0,0,0,0,0,0,0,0,
0,0,0,0,0,0,0,0,0,0,0,0,0,
0,0,0,1030,0,0,0,0,0,0,0,0,0,
0,0,0,0,0,0,0,0,0,0,0,0,0,
0,0,0,0,0,0,0,0,0,0,0,0,0,
0,0,0,0,0,0,0,0,0,0,0,0,0],

"point1": [[0,1],[2,1],[2,4],[4,4],[4,3],[5,3],[5,1],[7,1],[7,5],[9,5],[9,2],[11,2],[11,4],[12,4],[12,5]],
"point2": [[0,1],[2,1],[2,4],[4,4],[4,3],[5,3],[5,1],[7,1],[7,5],[9,5],[9,2],[11,2],[11,4],[12,4],[12,5]]

}
