{
"row":13,
"col":7,
"isloop":0,
"datas":[1,1,1,1,1,1,1,1,1,1,1,2,2,
0,1,1,1,1,1,1,2,2,2,1,2,2,
2,1,2,2,2,2,1,2,2,2,1,2,2,
2,1,1,1,2,2,1,2,2,2,1,1,1,
2,2,2,1,2,2,1,1,1,2,2,2,1,
1,1,1,1,2,2,2,2,1,2,2,2,1,
1,2,2,2,2,2,2,2,1,2,2,2,1],

"it1":[0,0,0,0,0,0,0,0,0,0,0,510,0,
0,0,0,0,0,0,0,404,506,404,0,0,0,
500,0,404,500,505,506,0,506,0,506,0,503,401,
506,0,0,0,0,0,0,0,501,0,0,0,0,
0,508,0,0,406,0,0,0,0,506,511,0,0,
0,0,0,0,0,0,506,505,0,0,0,0,0,
0,0,509,0,500,401,0,0,0,507,0,0,0],

"it2":[0,0,0,0,0,0,0,0,0,0,0,0,0,
0,0,0,0,0,0,0,1000,0,1040,0,0,0,
0,0,1040,0,0,0,0,0,0,0,0,0,0,
0,0,0,0,0,0,0,0,0,0,0,0,0,
0,0,0,0,0,0,0,0,0,0,0,0,0,
0,0,0,0,0,0,0,0,0,0,0,0,0,
0,0,0,0,0,0,0,0,0,0,0,0,0],

"point1": [[0,6],[0,5],[3,5],[3,3],[1,3],[1,1],[1,0],[0,0]],
"point2": [[8,6],[8,4],[6,4],[6,1],[1,1],[1,0],[0,0]],
"point3": [[12,6],[12,3],[10,3],[10,0],[1,0],[0,0]],
"point4": [[0,6],[0,5],[3,5],[3,3],[1,3],[1,1],[1,0],[0,0]],
"point5": [[12,6],[12,3],[10,3],[10,0],[1,0],[0,0]]

}
