{
"row":13,
"col":7,
"isloop":0,
"datas":[1,1,2,1,1,1,1,1,2,1,1,1,1,
2,1,2,1,2,2,2,1,2,1,2,2,1,
2,1,2,1,1,2,1,1,2,1,1,2,1,
2,1,2,2,1,2,1,2,2,2,1,2,1,
2,1,1,1,1,2,1,1,1,1,1,2,1,
2,2,2,2,2,2,2,2,2,2,2,2,1,
2,2,2,2,2,2,2,2,2,2,2,2,0],

"it1":[0,0,503,0,0,0,0,0,505,0,0,0,0,
504,0,506,0,404,505,500,0,0,0,509,0,0,
0,0,0,0,0,0,0,0,0,0,0,505,0,
505,0,425,501,0,504,0,508,0,503,0,0,0,
0,0,0,0,0,0,0,0,0,0,0,404,0,
508,0,404,406,0,404,503,507,0,503,511,0,0,
500,507,0,0,0,507,0,500,501,403,0,0,0],

"it2":[0,0,0,0,0,0,0,0,0,0,0,0,0,
0,0,0,0,1020,0,0,0,0,0,0,0,0,
0,0,0,0,0,0,0,0,0,0,0,0,0,
0,0,2011,0,0,0,0,0,0,0,0,0,0,
0,0,0,0,0,0,0,0,0,0,0,1020,0,
0,0,1020,0,0,1020,0,0,0,0,0,0,0,
0,0,0,0,0,0,0,0,0,0,0,0,0],

"point1": [[0,0],[1,0],[1,4],[4,4],[4,2],[3,2],[3,0],[7,0],[7,2],[6,2],[6,4],[10,4],[10,2],[9,2],[9,0],[12,0],[12,5]],
"point2": [[0,0],[1,0],[1,4],[4,4],[4,2],[3,2],[3,0],[7,0],[7,2],[6,2],[6,4],[10,4],[10,2],[9,2],[9,0],[12,0],[12,5]],
"point3": [[0,0],[1,0],[1,4],[4,4],[4,2],[3,2],[3,0],[7,0],[7,2],[6,2],[6,4],[10,4],[10,2],[9,2],[9,0],[12,0],[12,5]]

}
