{
"row":13,
"col":7,
"isloop":0,
"datas":[2,2,2,2,2,2,2,2,2,2,1,1,1,
2,2,2,2,2,2,2,2,2,2,1,2,2,
2,2,2,2,2,1,1,1,1,1,1,2,2,
2,1,1,1,2,1,2,2,2,2,2,2,2,
2,1,2,1,2,1,2,2,2,2,2,2,2,
2,1,2,1,1,1,2,2,2,2,2,2,2,
2,0,2,2,2,2,2,2,2,2,2,2,2],

"it1":[507,0,506,509,0,510,0,509,0,1011,0,0,0,
506,404,0,511,0,0,0,0,507,0,0,506,425,
0,509,0,0,0,0,0,0,0,0,0,0,503,
404,0,0,0,425,0,507,0,507,0,500,511,0,
401,0,506,0,503,0,503,403,425,511,0,0,0,
506,0,0,0,0,0,511,0,503,0,0,404,505,
0,0,507,0,507,0,0,0,501,501,500,401,0],

"it2":[0,0,0,0,0,0,0,0,0,0,0,0,0,
0,1310,0,0,0,0,0,0,0,0,0,0,6011,
0,0,0,0,0,0,0,0,0,0,0,0,0,
1000,0,0,0,1031,0,0,0,0,0,0,0,0,
0,0,0,0,0,0,0,0,1031,0,0,0,0,
0,0,0,0,0,0,0,0,0,0,0,1310,0,
0,0,0,0,0,0,0,0,0,0,0,0,0],

"point1": [[12,0],[10,0],[10,2],[5,2],[5,5],[3,5],[3,3],[1,3],[1,5]],
"point2": [[12,0],[10,0],[10,2],[5,2],[5,5],[3,5],[3,3],[1,3],[1,5]]

}
