{
"row":13,
"col":7,
"isloop":0,
"datas":[2,2,2,2,2,1,1,1,1,1,1,1,1,
2,2,2,2,2,1,2,2,2,2,2,2,1,
1,1,1,1,1,1,1,1,1,1,2,2,1,
1,2,2,2,2,1,2,2,2,1,2,2,1,
1,2,2,2,2,1,2,2,2,1,2,2,1,
1,2,2,2,2,1,2,2,2,1,2,2,2,
0,2,2,2,2,1,1,1,1,1,2,2,2],

"it1":[503,504,507,0,506,0,0,0,0,0,0,0,0,
0,0,508,0,0,0,509,0,503,404,509,0,0,
0,0,0,0,0,0,0,0,0,0,401,506,0,
0,509,0,404,503,0,425,511,0,0,506,0,0,
0,507,0,510,0,0,501,0,0,0,0,502,0,
0,500,403,0,0,0,509,0,425,0,511,0,503,
0,502,503,501,401,0,0,0,0,0,0,0,401],

"it2":[0,0,0,0,0,0,0,0,0,0,0,0,0,
0,0,0,0,0,0,0,0,0,1100,0,0,0,
0,0,0,0,0,0,0,0,0,0,0,0,0,
0,0,0,1100,0,0,3021,0,0,0,0,0,0,
0,0,0,0,0,0,0,0,0,0,0,0,0,
0,0,0,0,0,0,0,0,5021,0,0,0,0,
0,0,0,0,0,0,0,0,0,0,0,0,0],

"point1": [[12,4],[12,0],[5,0],[5,6],[9,6],[9,2],[0,2],[0,5]],
"point2": [[12,4],[12,0],[5,0],[5,6],[9,6],[9,2],[0,2],[0,5]]

}
