{
"row":13,
"col":7,
"isloop":0,
"datas":[2,1,1,1,2,2,2,2,2,1,1,1,2,
2,1,2,1,1,1,1,1,1,1,2,1,2,
2,1,2,2,2,2,0,2,2,2,2,1,2,
2,1,2,2,2,2,1,1,1,1,1,1,1,
2,1,2,2,2,2,2,2,2,2,2,1,2,
2,1,2,1,1,1,1,1,1,1,2,1,2,
2,1,1,1,2,2,2,2,2,1,1,1,2],

"it1":[404,0,0,0,1011,507,0,501,404,0,0,0,401,
506,0,504,0,0,0,0,0,0,0,404,0,506,
0,0,0,506,508,0,0,509,0,508,0,0,0,
503,0,505,0,511,0,0,0,0,0,0,0,0,
506,0,0,501,0,0,401,509,0,507,0,0,506,
0,0,404,0,0,0,0,0,0,0,404,0,0,
401,0,0,0,508,0,503,509,0,0,0,0,401],

"it2":[1100,0,0,0,0,0,0,0,2011,0,0,0,0,
0,0,0,0,0,0,0,0,0,0,1220,0,0,
0,0,0,0,0,0,0,0,0,0,0,0,0,
0,0,0,0,0,0,0,0,0,0,0,0,0,
0,0,0,0,0,0,0,0,0,0,0,0,0,
0,0,1100,0,0,0,0,0,0,0,1100,0,0,
0,0,0,0,0,0,0,0,0,0,0,0,0],

"point1": [[6,3],[11,3],[11,6],[9,6],[9,5],[3,5],[3,6],[1,6],[1,0],[3,0],[3,1],[6,1]],
"point2": [[6,3],[11,3],[11,6],[9,6],[9,5],[3,5],[3,6],[1,6],[1,0],[3,0],[3,1],[6,1]],
"point3": [[12,3],[11,3],[11,0],[9,0],[9,1],[6,1]]

}
