{
"row":13,
"col":7,
"isloop":0,
"datas":[2,2,2,2,2,1,1,2,2,2,2,2,2,
2,2,2,2,2,0,1,1,1,1,1,1,1,
1,1,1,1,1,1,1,1,1,1,1,1,1,
1,1,1,1,1,1,1,1,1,1,2,2,2,
2,2,1,1,1,1,1,1,1,1,2,2,2,
2,2,1,1,1,1,1,2,2,2,2,2,2,
2,2,2,2,2,2,1,2,2,2,2,2,2],

"it1":[504,0,503,509,0,0,0,509,0,401,508,0,404,
0,509,0,503,401,0,0,0,0,0,0,0,0,
0,0,0,0,0,0,0,0,0,0,0,0,0,
0,0,0,0,0,0,0,0,0,0,406,0,506,
503,404,0,0,0,0,0,0,0,0,0,0,0,
406,0,0,0,0,0,0,404,511,0,505,509,0,
0,0,503,404,509,0,0,503,0,0,0,502,501],

"it2":[0,0,0,0,0,0,0,0,0,0,0,0,1100,
0,0,0,0,0,0,0,0,0,0,0,0,0,
0,0,0,0,0,0,0,0,0,0,0,0,0,
0,0,0,0,0,0,0,0,0,0,0,0,0,
0,1100,0,0,0,0,0,0,0,0,0,0,0,
0,0,0,0,0,0,0,1100,0,0,0,0,0,
0,0,0,1100,0,0,0,0,0,0,0,0,0],

"point1": [[6,6],[6,5],[2,5],[2,4],[9,4],[9,3],[0,3],[0,2],[12,2],[12,1],[6,1],[6,0],[5,0]],
"point2": [[6,6],[6,5],[2,5],[2,4],[9,4],[9,3],[0,3],[0,2],[12,2],[12,1],[6,1],[6,0],[5,0]],
"point3": [[6,6],[6,5],[2,5],[2,4],[9,4],[9,3],[0,3],[0,2],[12,2],[12,1],[6,1],[6,0],[5,0]]

}
